league,season,team,player,nation,pos,age,born,90s,Tackles_Tkl,Tackles_TklW,Tackles_Def 3rd,Tackles_Mid 3rd,Tackles_Att 3rd,Challenges_Tkl,Challenges_Att,Challenges_Tkl%,Challenges_Lost,Blocks_Blocks,Blocks_Sh,Blocks_Pass,Int,Tkl+Int,Clr,Err
ENG-Premier League,2425,Arsenal,Ben White,ENG,DF,27-228,1997,12.3,18,12,10,4,4,15,33,45.5,18,10,8,2,16,34,43,0
ENG-Premier League,2425,Arsenal,Bukayo Saka,ENG,"FW,MF",23-261,2001,18.9,28,15,9,11,8,12,23,52.2,11,22,0,22,3,31,8,0
ENG-Premier League,2425,Arsenal,David Raya,ESP,GK,29-251,1995,37.0,0,0,0,0,0,0,2,0.0,2,0,0,0,2,2,20,9
ENG-Premier League,2425,Arsenal,Declan Rice,ENG,MF,26-130,1999,30.4,53,25,22,25,6,17,39,43.6,22,25,12,13,25,78,47,0
ENG-Premier League,2425,Arsenal,Ethan Nwaneri,ENG,"FW,MF",18-064,2007,9.1,11,7,4,4,3,7,18,38.9,11,8,2,6,2,13,4,1
ENG-Premier League,2425,Arsenal,Gabriel Jesus,BRA,FW,28-051,1997,6.8,10,6,4,3,3,4,9,44.4,5,10,1,9,4,14,8,0
ENG-Premier League,2425,Arsenal,Gabriel Magalhães,BRA,DF,27-156,1997,26.3,25,15,12,8,5,12,16,75.0,4,42,29,13,16,41,93,2
ENG-Premier League,2425,Arsenal,Gabriel Martinelli,BRA,"FW,MF",23-340,2001,24.7,21,15,9,5,7,7,23,30.4,16,14,0,14,5,26,19,0
ENG-Premier League,2425,Arsenal,Jakub Kiwior,POL,DF,25-098,2000,11.5,19,8,11,6,2,11,14,78.6,3,11,7,4,6,25,53,2
ENG-Premier League,2425,Arsenal,Jorginho,ITA,MF,33-155,1991,7.8,12,4,1,7,4,8,20,40.0,12,3,0,3,7,19,2,2
ENG-Premier League,2425,Arsenal,Jurriën Timber,NED,DF,23-341,2001,26.9,58,38,17,30,11,18,27,66.7,9,19,4,15,22,80,44,1
ENG-Premier League,2425,Arsenal,Kai Havertz,GER,"FW,MF",25-347,1999,20.6,16,9,3,6,7,4,15,26.7,11,23,4,19,6,22,33,1
ENG-Premier League,2425,Arsenal,Kieran Tierney,SCO,"DF,FW",27-353,1997,2.2,6,5,4,1,1,4,6,66.7,2,0,0,0,2,8,5,0
ENG-Premier League,2425,Arsenal,Leandro Trossard,BEL,FW,30-171,1994,28.0,30,20,6,15,9,12,34,35.3,22,32,0,32,9,39,18,0
ENG-Premier League,2425,Arsenal,Martin Ødegaard,NOR,MF,26-158,1998,25.7,19,11,9,7,3,4,24,16.7,20,5,0,5,6,25,6,1
ENG-Premier League,2425,Arsenal,Mikel Merino,ESP,"MF,FW",28-336,1996,16.6,43,26,7,24,12,18,33,54.5,15,18,5,13,15,58,25,2
ENG-Premier League,2425,Arsenal,Myles Lewis-Skelly,ENG,DF,18-240,2006,15.0,22,14,10,9,3,10,11,90.9,1,3,1,2,7,29,25,0
ENG-Premier League,2425,Arsenal,Nathan Butler-Oyedeji,ENG,FW,22-140,2003,0.1,0,0,0,0,0,0,0,,0,0,0,0,0,0,0,0
ENG-Premier League,2425,Arsenal,Oleksandr Zinchenko,UKR,"DF,MF",28-160,1996,5.1,4,1,1,2,1,2,7,28.6,5,6,1,5,4,8,6,0
ENG-Premier League,2425,Arsenal,Raheem Sterling,ENG,"FW,MF",30-167,1994,4.9,8,4,1,2,5,4,8,50.0,4,3,0,3,1,9,3,0
ENG-Premier League,2425,Arsenal,Reiss Nelson,ENG,FW,25-165,1999,0.0,1,0,0,1,0,0,1,0.0,1,0,0,0,0,1,1,0
ENG-Premier League,2425,Arsenal,Riccardo Calafiori,ITA,DF,23-005,2002,10.9,27,19,15,10,2,18,29,62.1,11,12,6,6,9,36,25,0
ENG-Premier League,2425,Arsenal,Takehiro Tomiyasu,JPN,DF,26-200,1998,0.1,0,0,0,0,0,0,0,,0,0,0,0,0,0,1,0
ENG-Premier League,2425,Arsenal,Thomas Partey,GHA,"MF,DF",31-345,1993,30.1,87,53,26,38,23,45,74,60.8,29,28,8,20,35,122,47,4
ENG-Premier League,2425,Arsenal,William Saliba,FRA,DF,24-061,2001,33.8,62,37,37,23,2,21,28,75.0,7,25,15,10,21,83,119,7
ENG-Premier League,2425,Aston Villa,Amadou Onana,BEL,MF,23-281,2001,17.3,53,28,23,26,4,15,28,53.6,13,15,7,8,26,79,41,3
ENG-Premier League,2425,Aston Villa,Andrés García,ESP,"DF,MF",22-106,2003,3.5,9,5,5,3,1,4,8,50.0,4,2,0,2,2,11,10,2
ENG-Premier League,2425,Aston Villa,Axel Disasi,FRA,DF,27-074,1998,5.4,8,5,7,1,0,3,7,42.9,4,4,1,3,5,13,18,0
ENG-Premier League,2425,Aston Villa,Boubacar Kamara,FRA,MF,25-182,1999,18.3,50,21,28,18,4,29,56,51.8,27,18,7,11,19,69,50,3
ENG-Premier League,2425,Aston Villa,Diego Carlos,BRA,DF,32-070,1993,9.2,8,3,6,1,1,4,6,66.7,2,13,7,6,5,13,36,2
ENG-Premier League,2425,Aston Villa,Donyell Malen,NED,FW,26-135,1999,3.3,7,4,3,3,1,1,4,25.0,3,2,0,2,0,7,1,0
ENG-Premier League,2425,Aston Villa,Emi Buendía,ARG,"MF,FW",28-150,1996,1.1,6,6,3,2,1,0,5,0.0,5,5,1,4,0,6,2,0
ENG-Premier League,2425,Aston Villa,Emiliano Martínez,ARG,GK,32-264,1992,35.0,3,3,3,0,0,2,2,100.0,0,1,0,1,0,3,17,6
ENG-Premier League,2425,Aston Villa,Ezri Konsa,ENG,DF,27-213,1997,31.6,34,18,20,10,4,20,25,80.0,5,18,10,8,22,56,110,4
ENG-Premier League,2425,Aston Villa,Ian Maatsen,NED,DF,23-075,2002,11.7,29,17,17,9,3,17,24,70.8,7,13,0,13,15,44,35,2
ENG-Premier League,2425,Aston Villa,Jacob Ramsey,ENG,"FW,MF",23-361,2001,17.7,30,15,14,10,6,10,20,50.0,10,23,4,19,8,38,8,1
ENG-Premier League,2425,Aston Villa,Jaden Philogene Bidace,ENG,"FW,MF",23-105,2002,3.7,11,5,4,7,0,4,6,66.7,2,5,0,5,3,14,2,1
ENG-Premier League,2425,Aston Villa,John McGinn,SCO,"MF,FW",30-218,1994,24.0,33,24,10,14,9,13,31,41.9,18,22,2,20,14,47,17,3
ENG-Premier League,2425,Aston Villa,Jáder Durán,COL,FW,21-162,2003,7.1,8,7,1,2,5,1,4,25.0,3,5,0,5,0,8,13,0
ENG-Premier League,2425,Aston Villa,Kosta Nedeljković,SRB,DF,19-159,2005,1.4,7,5,1,3,3,2,3,66.7,1,1,0,1,0,7,3,0
ENG-Premier League,2425,Aston Villa,Lamare Bogarde,NED,"DF,MF",21-139,2004,5.3,14,6,6,6,2,10,16,62.5,6,5,3,2,1,15,13,0
ENG-Premier League,2425,Aston Villa,Leon Bailey,JAM,"FW,MF",27-288,1997,12.7,7,5,2,3,2,3,11,27.3,8,6,0,6,3,10,12,0
ENG-Premier League,2425,Aston Villa,Lucas Digne,FRA,DF,31-308,1993,26.1,65,38,40,16,9,44,66,66.7,22,23,4,19,25,90,89,1
ENG-Premier League,2425,Aston Villa,Marco Asensio,ESP,MF,29-123,1996,7.8,7,5,0,7,0,3,9,33.3,6,7,1,6,2,9,3,0
ENG-Premier League,2425,Aston Villa,Marcus Rashford,ENG,FW,27-205,1997,4.9,10,7,2,3,5,4,6,66.7,2,2,0,2,1,11,3,0
ENG-Premier League,2425,Aston Villa,Matty Cash,POL,DF,27-290,1997,22.0,52,30,27,21,4,27,39,69.2,12,21,8,13,22,74,65,2
ENG-Premier League,2425,Aston Villa,Morgan Rogers,ENG,"FW,MF",22-302,2002,33.7,41,22,15,14,12,23,46,50.0,23,26,7,19,5,46,20,2
ENG-Premier League,2425,Aston Villa,Ollie Watkins,ENG,FW,29-145,1995,27.9,10,7,0,6,4,3,11,27.3,8,11,3,8,8,18,15,2
ENG-Premier League,2425,Aston Villa,Pau Torres,ESP,DF,28-128,1997,21.4,21,15,11,8,2,10,17,58.8,7,14,10,4,9,30,69,2
ENG-Premier League,2425,Aston Villa,Robin Olsen,SWE,GK,35-136,1990,2.0,1,0,1,0,0,1,1,100.0,0,0,0,0,0,1,2,1
ENG-Premier League,2425,Aston Villa,Ross Barkley,ENG,MF,31-170,1993,6.4,14,3,4,10,0,9,14,64.3,5,9,3,6,10,24,5,0
ENG-Premier League,2425,Aston Villa,Tyrone Mings,ENG,DF,32-072,1993,12.4,7,6,6,1,0,2,2,100.0,0,13,11,2,7,14,61,1
ENG-Premier League,2425,Aston Villa,Youri Tielemans,BEL,MF,28-017,1997,33.3,83,57,31,44,8,40,73,54.8,33,37,16,21,22,105,47,4
ENG-Premier League,2425,Bournemouth,Adam Smith,ENG,DF,34-025,1991,16.7,22,10,11,5,6,12,25,48.0,13,13,5,8,14,36,48,1
ENG-Premier League,2425,Bournemouth,Alex Scott,ENG,MF,21-276,2003,8.4,27,14,11,8,8,19,42,45.2,23,17,4,13,10,37,15,0
ENG-Premier League,2425,Bournemouth,Antoine Semenyo,GHA,FW,25-137,2000,34.6,54,34,17,24,13,16,42,38.1,26,66,9,57,11,65,39,2
ENG-Premier League,2425,Bournemouth,Ben Winterburn,ENG,"FW,MF",20-262,2004,0.3,0,0,0,0,0,0,1,0.0,1,0,0,0,2,2,0,0
ENG-Premier League,2425,Bournemouth,Dango Ouattara,BFA,FW,23-102,2002,22.3,35,26,14,11,10,17,41,41.5,24,36,10,26,11,46,51,0
ENG-Premier League,2425,Bournemouth,Daniel Jebbison,ENG,FW,21-284,2003,1.0,3,2,2,1,0,3,5,60.0,2,2,1,1,1,4,1,0
ENG-Premier League,2425,Bournemouth,David Brooks,WAL,"FW,MF",27-320,1997,10.0,12,5,2,7,3,1,14,7.1,13,18,2,16,5,17,9,1
ENG-Premier League,2425,Bournemouth,Dean Huijsen,ESP,DF,20-040,2005,26.8,36,26,19,16,1,18,29,62.1,11,39,29,10,51,87,197,4
ENG-Premier League,2425,Bournemouth,Enes Ünal,TUR,"FW,MF",28-014,1997,3.8,1,0,0,0,1,0,3,0.0,3,1,0,1,0,1,6,0
ENG-Premier League,2425,Bournemouth,Evanilson,BRA,FW,25-230,1999,24.8,16,10,6,5,5,8,12,66.7,4,11,2,9,1,17,21,0
ENG-Premier League,2425,Bournemouth,Illia Zabarnyi,UKR,DF,22-265,2002,33.5,51,35,30,20,1,33,48,68.8,15,33,20,13,39,90,179,2
ENG-Premier League,2425,Bournemouth,James Hill,ENG,DF,23-134,2002,5.0,15,8,6,6,3,3,11,27.3,8,5,0,5,9,24,31,0
ENG-Premier League,2425,Bournemouth,Julian Araujo,MEX,DF,23-284,2001,5.5,10,5,4,6,0,5,12,41.7,7,3,0,3,6,16,18,0
ENG-Premier League,2425,Bournemouth,Julio Soler,ARG,"DF,FW",20-097,2005,0.1,1,1,1,0,0,1,1,100.0,0,1,0,1,0,1,0,0
ENG-Premier League,2425,Bournemouth,Justin Kluivert,NED,"MF,FW",26-019,1999,25.0,21,9,4,10,7,4,22,18.2,18,24,0,24,13,34,23,1
ENG-Premier League,2425,Bournemouth,Kepa Arrizabalaga,ESP,GK,30-233,1994,30.0,1,0,1,0,0,0,2,0.0,2,2,0,2,0,1,15,3
ENG-Premier League,2425,Bournemouth,Lewis Cook,ENG,"MF,DF",28-110,1997,33.1,81,42,41,36,4,37,67,55.2,30,30,11,19,41,122,70,0
ENG-Premier League,2425,Bournemouth,Luis Sinisterra,COL,"FW,MF",25-341,1999,2.6,7,2,3,2,2,0,4,0.0,4,3,0,3,1,8,8,0
ENG-Premier League,2425,Bournemouth,Marcos Senesi,ARG,DF,28-014,1997,11.4,36,21,23,11,2,14,30,46.7,16,15,7,8,11,47,56,0
ENG-Premier League,2425,Bournemouth,Marcus Tavernier,ENG,"FW,MF",26-063,1999,20.6,43,24,15,19,9,10,26,38.5,16,16,3,13,5,48,11,0
ENG-Premier League,2425,Bournemouth,Mark Travers,IRL,GK,26-006,1999,5.0,0,0,0,0,0,0,0,,0,0,0,0,0,0,5,0
ENG-Premier League,2425,Bournemouth,Max Aarons,ENG,DF,25-140,2000,1.0,2,2,1,1,0,1,1,100.0,0,3,1,2,1,3,0,0
ENG-Premier League,2425,Bournemouth,Milos Kerkez,HUN,DF,21-198,2003,36.1,52,26,25,20,7,24,38,63.2,14,37,11,26,45,97,104,4
ENG-Premier League,2425,Bournemouth,Neto,BRA,GK,35-309,1989,2.0,0,0,0,0,0,0,0,,0,0,0,0,0,0,1,1
ENG-Premier League,2425,Bournemouth,Philip Billing,DEN,MF,28-347,1996,2.0,14,5,7,6,1,3,4,75.0,1,3,0,3,5,19,2,0
ENG-Premier League,2425,Bournemouth,Remy Rees-Dottin,ENG,FW,19-079,2006,0.0,0,0,0,0,0,0,0,,0,0,0,0,0,0,0,0
ENG-Premier League,2425,Bournemouth,Ryan Christie,SCO,MF,30-091,1995,23.5,54,33,19,27,8,27,64,42.2,37,44,11,33,30,84,51,3
ENG-Premier League,2425,Bournemouth,Tyler Adams,USA,MF,26-099,1999,20.8,81,49,25,49,7,39,72,54.2,33,33,10,23,32,113,41,0
ENG-Premier League,2425,Bournemouth,Zain Silcott-Duberry,MSR,FW,19-319,2005,0.0,1,1,0,0,1,1,1,100.0,0,0,0,0,0,1,0,0
ENG-Premier League,2425,Brentford,Ben Mee,ENG,DF,35-245,1989,2.0,2,2,0,2,0,1,1,100.0,0,3,3,0,4,6,7,0
ENG-Premier League,2425,Brentford,Bryan Mbeumo,CMR,FW,25-290,1999,36.9,45,29,17,14,14,18,32,56.3,14,24,3,21,14,59,53,1
ENG-Premier League,2425,Brentford,Christian Nørgaard,DEN,MF,31-075,1994,30.3,76,46,35,34,7,45,74,60.8,29,52,20,32,48,124,67,1
ENG-Premier League,2425,Brentford,Edmond-Paris Maghoma,ENG,"MF,FW",24-016,2001,1.3,2,1,0,2,0,1,3,33.3,2,2,2,0,1,3,2,0
ENG-Premier League,2425,Brentford,Ethan Pinnock,JAM,DF,31-360,1993,21.3,35,19,15,16,4,13,24,54.2,11,29,18,11,24,59,142,4
ENG-Premier League,2425,Brentford,Fabio Carvalho,POR,"FW,MF",22-267,2002,5.1,13,9,4,4,5,6,13,46.2,7,6,1,5,3,16,2,0
ENG-Premier League,2425,Brentford,Frank Onyeka,NGA,MF,27-143,1998,0.3,0,0,0,0,0,0,0,,0,0,0,0,0,0,0,0
ENG-Premier League,2425,Brentford,Gustavo Nunes,BRA,"FW,MF",19-185,2005,0.1,3,2,2,0,1,2,2,100.0,0,0,0,0,0,3,2,0
ENG-Premier League,2425,Brentford,Hákon Rafn Valdimarsson,ISL,GK,23-223,2001,1.6,0,0,0,0,0,0,0,,0,0,0,0,0,0,2,0
ENG-Premier League,2425,Brentford,Jayden Meghoma,ENG,DF,18-330,2006,0.1,0,0,0,0,0,0,0,,0,0,0,0,0,0,0,0
ENG-Premier League,2425,Brentford,Keane Lewis-Potter,ENG,"DF,FW",24-091,2001,33.4,46,26,25,15,6,28,46,60.9,18,27,10,17,19,65,73,3
ENG-Premier League,2425,Brentford,Kevin Schade,GER,FW,23-178,2001,24.6,36,23,14,10,12,12,21,57.1,9,19,4,15,5,41,33,0
ENG-Premier League,2425,Brentford,Kim Jisoo,KOR,DF,20-151,2004,0.3,0,0,0,0,0,0,0,,0,0,0,0,0,0,2,0
ENG-Premier League,2425,Brentford,Kristoffer Ajer,NOR,DF,27-037,1998,15.9,26,18,14,11,1,14,27,51.9,13,17,4,13,12,38,50,0
ENG-Premier League,2425,Brentford,Mads Roerslev,DEN,DF,25-334,1999,12.2,18,8,14,3,1,11,28,39.3,17,12,5,7,4,22,35,0
ENG-Premier League,2425,Brentford,Mark Flekken,NED,GK,31-345,1993,35.4,4,4,4,0,0,3,9,33.3,6,2,0,2,0,4,26,4
ENG-Premier League,2425,Brentford,Mathias Jensen,DEN,MF,29-143,1996,9.5,14,10,6,6,2,8,16,50.0,8,13,4,9,8,22,13,1
ENG-Premier League,2425,Brentford,Michael Kayode,ITA,DF,20-318,2004,4.9,15,10,11,4,0,9,13,69.2,4,3,0,3,5,20,17,0
ENG-Premier League,2425,Brentford,Mikkel Damsgaard,DEN,"MF,FW",24-325,2000,31.5,81,44,27,28,26,30,77,39.0,47,39,2,37,26,107,30,2
ENG-Premier League,2425,Brentford,Nathan Collins,IRL,DF,24-024,2001,37.0,39,23,23,12,4,22,35,62.9,13,76,56,20,34,73,221,3
ENG-Premier League,2425,Brentford,Rico Henry,ENG,DF,27-320,1997,1.1,2,2,1,0,1,0,4,0.0,4,4,1,3,1,3,2,0
ENG-Premier League,2425,Brentford,Ryan Trevitt,ENG,MF,22-073,2003,0.0,1,1,1,0,0,0,0,,0,0,0,0,0,1,0,0
ENG-Premier League,2425,Brentford,Sepp van den Berg,NED,DF,23-155,2001,27.7,38,23,24,10,4,18,27,66.7,9,51,37,14,21,59,127,3
ENG-Premier League,2425,Brentford,Thiago,BRA,"FW,MF",23-332,2001,1.8,5,3,2,1,2,0,1,0.0,1,3,0,3,2,7,2,1
ENG-Premier League,2425,Brentford,Vitaly Janelt,GER,MF,27-014,1998,25.0,38,22,14,13,11,21,36,58.3,15,33,9,24,27,65,53,1
ENG-Premier League,2425,Brentford,Yehor Yarmoliuk,UKR,MF,21-084,2004,15.1,45,26,18,20,7,27,51,52.9,24,25,8,17,13,58,33,0
ENG-Premier League,2425,Brentford,Yoane Wissa,COD,FW,28-263,1996,31.4,22,12,6,8,8,11,27,40.7,16,29,8,21,8,30,21,3
ENG-Premier League,2425,Brentford,Yunus Emre Konak,TUR,"FW,MF",19-134,2006,0.5,4,4,0,4,0,1,2,50.0,1,2,0,2,0,4,0,0
ENG-Premier League,2425,Brighton,Adam Webster,ENG,DF,30-140,1995,8.9,10,6,5,4,1,6,14,42.9,8,13,9,4,19,29,39,2
ENG-Premier League,2425,Brighton,Bart Verbruggen,NED,GK,22-279,2002,35.0,0,0,0,0,0,0,3,0.0,3,1,0,1,0,0,29,5
ENG-Premier League,2425,Brighton,Billy Gilmour,SCO,MF,23-347,2001,1.1,3,3,2,1,0,3,4,75.0,1,1,0,1,0,3,1,0
ENG-Premier League,2425,Brighton,Brajan Gruda,GER,"MF,FW",20-358,2004,6.8,14,6,6,5,3,7,14,50.0,7,8,0,8,2,16,5,1
ENG-Premier League,2425,Brighton,Carlos Baleba,CMR,MF,21-141,2004,28.6,76,43,26,34,16,47,78,60.3,31,46,11,35,44,120,44,1
ENG-Premier League,2425,Brighton,Danny Welbeck,ENG,FW,34-179,1990,23.5,26,16,6,15,5,8,20,40.0,12,19,4,15,5,31,14,0
ENG-Premier League,2425,Brighton,Diego Gómez,PAR,MF,22-058,2003,5.2,20,12,11,7,2,12,22,54.5,10,13,0,13,8,28,10,1
ENG-Premier League,2425,Brighton,Eiran Cashin,IRL,DF,23-196,2001,0.2,0,0,0,0,0,0,1,0.0,1,0,0,0,0,0,2,0
ENG-Premier League,2425,Brighton,Evan Ferguson,IRL,FW,20-217,2004,2.7,4,3,0,3,1,2,5,40.0,3,3,1,2,0,4,4,0
ENG-Premier League,2425,Brighton,Ferdi Kadioglu,TUR,"DF,MF",25-229,1999,4.3,10,6,4,5,1,6,15,40.0,9,2,2,0,8,18,17,0
ENG-Premier League,2425,Brighton,Georginio Rutter,FRA,"MF,FW",23-034,2002,18.4,39,15,13,18,8,14,36,38.9,22,20,3,17,10,49,13,2
ENG-Premier League,2425,Brighton,Harry Howell,ENG,FW,16-237,2008,0.1,1,1,1,0,0,1,2,50.0,1,1,0,1,0,1,0,0
ENG-Premier League,2425,Brighton,Igor,BRA,DF,27-106,1998,10.0,4,4,2,1,1,4,10,40.0,6,23,14,9,4,8,39,1
ENG-Premier League,2425,Brighton,Jack Hinshelwood,ENG,"DF,MF",20-043,2005,19.5,26,18,8,10,8,11,27,40.7,16,8,3,5,16,42,37,1
ENG-Premier League,2425,Brighton,Jakub Moder,POL,MF,26-047,1999,0.1,1,0,1,0,0,0,2,0.0,2,0,0,0,0,1,3,0
ENG-Premier League,2425,Brighton,James Milner,ENG,MF,39-140,1986,1.9,5,2,1,3,1,3,3,100.0,0,4,2,2,2,7,2,1
ENG-Premier League,2425,Brighton,Jan Paul van Hecke,NED,DF,24-350,2000,31.9,44,29,23,19,2,22,40,55.0,18,35,21,14,24,68,140,2
ENG-Premier League,2425,Brighton,Jason Steele,ENG,GK,34-279,1990,2.0,0,0,0,0,0,0,0,,0,0,0,0,0,0,1,0
ENG-Premier League,2425,Brighton,Jeremy Sarmiento,ECU,MF,22-342,2002,0.1,0,0,0,0,0,0,0,,0,0,0,0,0,0,0,0
ENG-Premier League,2425,Brighton,João Pedro,BRA,"FW,MF",23-240,2001,21.6,16,12,6,6,4,4,11,36.4,7,12,0,12,9,25,12,0
ENG-Premier League,2425,Brighton,Joël Veltman,NED,DF,33-129,1992,18.5,42,28,23,16,3,30,51,58.8,21,22,7,15,18,60,66,0
ENG-Premier League,2425,Brighton,Julio Enciso,PAR,"MF,FW",21-121,2004,3.3,0,0,0,0,0,0,2,0.0,2,2,0,2,0,0,1,0
ENG-Premier League,2425,Brighton,Kaoru Mitoma,JPN,"FW,MF",28-004,1997,28.4,44,26,15,13,16,19,48,39.6,29,48,3,45,13,57,10,0
ENG-Premier League,2425,Brighton,Lewis Dunk,ENG,DF,33-184,1991,23.1,17,10,8,7,2,11,19,57.9,8,28,18,10,13,30,79,2
ENG-Premier League,2425,Brighton,Mats Wieffer,NED,"MF,DF",25-189,1999,10.3,52,28,26,22,4,29,42,69.0,13,16,2,14,15,67,25,3
ENG-Premier League,2425,Brighton,Matt O'Riley,DEN,MF,24-184,2000,10.3,16,9,4,8,4,4,13,30.8,9,7,3,4,13,29,9,1
ENG-Premier League,2425,Brighton,Pervis Estupiñán,ECU,DF,27-123,1998,26.7,65,43,33,25,7,34,51,66.7,17,20,5,15,37,102,65,2
ENG-Premier League,2425,Brighton,Simon Adingra,CIV,"FW,MF",23-143,2002,11.7,23,14,10,8,5,10,26,38.5,16,12,0,12,8,31,6,2
ENG-Premier League,2425,Brighton,Solly March,ENG,"FW,MF",30-308,1994,1.9,6,3,2,2,2,5,8,62.5,3,3,0,3,2,8,2,1
ENG-Premier League,2425,Brighton,Tariq Lamptey,GHA,DF,24-236,2000,9.6,17,11,8,9,0,9,25,36.0,16,15,7,8,7,24,23,1
ENG-Premier League,2425,Brighton,Yankuba Minteh,GAM,"FW,MF",20-306,2004,19.4,48,35,25,13,10,17,45,37.8,28,21,0,21,11,59,31,0
ENG-Premier League,2425,Brighton,Yasin Ayari,SWE,MF,21-230,2003,21.3,58,32,15,31,12,25,55,45.5,30,24,6,18,20,78,25,0
ENG-Premier League,2425,Chelsea,Axel Disasi,FRA,DF,27-074,1998,4.0,7,4,5,1,1,6,11,54.5,5,4,1,3,2,9,11,1
ENG-Premier League,2425,Chelsea,Benoît Badiashile,FRA,DF,24-059,2001,3.7,9,6,5,4,0,4,5,80.0,1,2,2,0,6,15,12,2
ENG-Premier League,2425,Chelsea,Christopher Nkunku,FRA,FW,27-191,1997,10.2,12,8,3,4,5,6,8,75.0,2,9,2,7,7,19,10,0
ENG-Premier League,2425,Chelsea,Cole Palmer,ENG,MF,23-018,2002,34.5,31,18,11,10,10,10,24,41.7,14,16,1,15,11,42,18,1
ENG-Premier League,2425,Chelsea,Enzo Fernández,ARG,MF,24-127,2001,31.7,65,33,17,30,18,31,84,36.9,53,42,7,35,13,78,22,4
ENG-Premier League,2425,Chelsea,Filip Jørgensen,DEN,GK,23-038,2002,6.0,0,0,0,0,0,0,0,,0,0,0,0,0,0,0,3
ENG-Premier League,2425,Chelsea,Jadon Sancho,ENG,FW,25-060,2000,18.9,11,7,3,2,6,5,12,41.7,7,10,0,10,2,13,6,2
ENG-Premier League,2425,Chelsea,Joshua Acheampong,ENG,DF,19-019,2006,1.9,2,1,2,0,0,2,2,100.0,0,1,0,1,1,3,2,0
ENG-Premier League,2425,Chelsea,João Félix,POR,"FW,MF",25-195,1999,4.1,8,3,2,5,1,5,9,55.6,4,2,0,2,3,11,2,0
ENG-Premier League,2425,Chelsea,Kiernan Dewsbury-Hall,ENG,"MF,FW",26-260,1998,2.9,8,5,1,1,6,4,6,66.7,2,2,0,2,1,9,8,1
ENG-Premier League,2425,Chelsea,Levi Colwill,ENG,DF,22-087,2003,34.0,47,34,25,19,3,18,27,66.7,9,37,25,12,32,79,112,4
ENG-Premier League,2425,Chelsea,Malo Gusto,FRA,DF,22-005,2003,20.5,45,29,27,15,3,25,48,52.1,23,29,8,21,24,69,49,5
ENG-Premier League,2425,Chelsea,Marc Cucurella,ESP,DF,26-306,1998,32.2,64,42,31,28,5,29,57,50.9,28,47,15,32,28,92,87,3
ENG-Premier League,2425,Chelsea,Marc Guiu,ESP,FW,19-140,2006,0.8,1,1,0,1,0,1,1,100.0,0,0,0,0,0,1,0,0
ENG-Premier League,2425,Chelsea,Mathis Amougou,FRA,MF,19-126,2006,0.1,0,0,0,0,0,0,0,,0,0,0,0,0,0,0,0
ENG-Premier League,2425,Chelsea,Moisés Caicedo,ECU,"MF,DF",23-203,2001,36.2,110,70,41,53,16,53,85,62.4,32,48,10,38,49,159,57,1
ENG-Premier League,2425,Chelsea,Mykhailo Mudryk,UKR,FW,24-139,2001,1.7,2,2,2,0,0,0,0,,0,3,1,2,0,2,1,0
ENG-Premier League,2425,Chelsea,Nicolas Jackson,SEN,FW,23-338,2001,24.7,22,13,6,7,9,5,10,50.0,5,15,2,13,3,25,15,0
ENG-Premier League,2425,Chelsea,Noni Madueke,ENG,FW,23-075,2002,21.6,23,16,7,12,4,13,37,35.1,24,17,0,17,9,32,11,0
ENG-Premier League,2425,Chelsea,Pedro Neto,POR,FW,25-076,2000,24.4,23,9,9,9,5,9,21,42.9,12,14,2,12,9,32,6,0
ENG-Premier League,2425,Chelsea,Reece James,ENG,"DF,MF",25-167,1999,10.8,9,9,5,3,1,3,9,33.3,6,12,4,8,13,22,21,4
ENG-Premier League,2425,Chelsea,Renato Veiga,POR,"DF,MF",21-299,2003,2.0,9,6,6,3,0,4,12,33.3,8,3,1,2,1,10,2,0
ENG-Premier League,2425,Chelsea,Robert Sánchez,ESP,GK,27-187,1997,31.0,0,0,0,0,0,0,1,0.0,1,0,0,0,2,2,23,9
ENG-Premier League,2425,Chelsea,Roméo Lavia,BEL,MF,21-138,2004,8.5,22,13,5,13,4,10,21,47.6,11,6,0,6,16,38,10,1
ENG-Premier League,2425,Chelsea,Shumaira Mheuka,ENG,MF,17-216,2007,0.0,0,0,0,0,0,0,0,,0,0,0,0,0,0,0,0
ENG-Premier League,2425,Chelsea,Tosin Adarabioyo,ENG,DF,27-242,1997,14.7,17,13,11,6,0,8,12,66.7,4,9,7,2,10,27,68,0
ENG-Premier League,2425,Chelsea,Trevoh Chalobah,ENG,DF,25-323,1999,10.1,11,7,5,6,0,7,8,87.5,1,6,3,3,10,21,48,1
ENG-Premier League,2425,Chelsea,Tyrique George,ENG,FW,19-109,2006,2.0,2,0,2,0,0,2,3,66.7,1,1,0,1,2,4,1,0
ENG-Premier League,2425,Chelsea,Wesley Fofana,FRA,DF,24-158,2000,13.0,13,12,6,7,0,6,14,42.9,8,14,9,5,14,27,55,2
ENG-Premier League,2425,Crystal Palace,Adam Wharton,ENG,MF,20-356,2004,14.6,34,14,14,16,4,17,44,38.6,27,11,2,9,20,54,27,0
ENG-Premier League,2425,Crystal Palace,Asher Agbinone,ENG,MF,19-238,2005,0.1,2,1,0,2,0,0,0,,0,0,0,0,0,2,0,0
ENG-Premier League,2425,Crystal Palace,Ben Chilwell,ENG,DF,28-154,1996,2.9,7,6,4,3,0,1,5,20.0,4,6,2,4,6,13,16,0
ENG-Premier League,2425,Crystal Palace,Caleb Kporha,ENG,DF,18-313,2006,0.1,2,1,2,0,0,2,2,100.0,0,0,0,0,0,2,1,0
ENG-Premier League,2425,Crystal Palace,Chadi Riad,MAR,DF,21-341,2003,1.0,5,2,2,2,1,2,3,66.7,1,0,0,0,2,7,0,0
ENG-Premier League,2425,Crystal Palace,Cheick Doucouré,MLI,MF,25-136,2000,5.0,16,8,6,8,2,5,11,45.5,6,4,0,4,11,27,10,1
ENG-Premier League,2425,Crystal Palace,Chris Richards,USA,DF,25-057,2000,20.4,46,29,23,17,6,23,40,57.5,17,39,14,25,19,65,110,0
ENG-Premier League,2425,Crystal Palace,Daichi Kamada,JPN,MF,28-292,1996,16.4,46,28,19,23,4,14,40,35.0,26,22,5,17,16,62,14,0
ENG-Premier League,2425,Crystal Palace,Daniel Muñoz,COL,DF,28-363,1996,34.9,120,79,56,40,24,54,94,57.4,40,39,5,34,42,162,105,1
ENG-Premier League,2425,Crystal Palace,Dean Henderson,ENG,GK,28-073,1997,37.0,2,1,2,0,0,2,6,33.3,4,0,0,0,0,2,22,0
ENG-Premier League,2425,Crystal Palace,Eberechi Eze,ENG,"MF,FW",26-329,1998,28.1,39,22,14,16,9,17,36,47.2,19,27,0,27,11,50,9,3
ENG-Premier League,2425,Crystal Palace,Eddie Nketiah,ENG,"FW,MF",25-359,1999,11.2,15,8,7,4,4,6,12,50.0,6,10,1,9,3,18,12,0
ENG-Premier League,2425,Crystal Palace,Ismaila Sarr,SEN,MF,27-088,1998,29.1,21,10,9,9,3,7,23,30.4,16,27,8,19,9,30,38,0
ENG-Premier League,2425,Crystal Palace,Jean-Philippe Mateta,FRA,FW,27-330,1997,28.7,17,12,4,11,2,3,16,18.8,13,18,4,14,2,19,22,0
ENG-Premier League,2425,Crystal Palace,Jefferson Lerma,COL,"MF,DF",30-211,1994,24.3,34,17,14,16,4,19,36,52.8,17,37,18,19,37,71,68,1
ENG-Premier League,2425,Crystal Palace,Jeffrey Schlupp,GHA,"MF,DF",32-152,1992,1.1,2,0,1,0,1,0,3,0.0,3,6,0,6,0,2,2,0
ENG-Premier League,2425,Crystal Palace,Joachim Andersen,DEN,DF,28-358,1996,1.0,1,1,1,0,0,1,2,50.0,1,0,0,0,0,1,7,0
ENG-Premier League,2425,Crystal Palace,Joel Ward,ENG,DF,35-207,1989,0.8,2,0,0,2,0,0,0,,0,0,0,0,0,2,3,0
ENG-Premier League,2425,Crystal Palace,Jordan Ayew,GHA,"FW,MF",33-255,1991,0.2,1,0,0,0,1,0,0,,0,0,0,0,0,1,0,0
ENG-Premier League,2425,Crystal Palace,Justin Devenny,NIR,MF,21-225,2003,5.3,14,9,6,7,1,7,17,41.2,10,6,1,5,0,14,11,0
ENG-Premier League,2425,Crystal Palace,Marc Guéhi,ENG,DF,24-315,2000,34.0,61,34,36,23,2,31,47,66.0,16,55,23,32,28,89,162,2
ENG-Premier League,2425,Crystal Palace,Matheus França,BRA,"MF,FW",21-053,2004,0.6,2,0,0,2,0,0,0,,0,1,1,0,1,3,1,0
ENG-Premier League,2425,Crystal Palace,Maxence Lacroix,FRA,DF,25-048,2000,33.6,67,40,51,15,1,32,47,68.1,15,44,19,25,53,120,197,2
ENG-Premier League,2425,Crystal Palace,Nathaniel Clyne,ENG,"DF,MF",34-049,1991,5.4,12,8,8,3,1,6,11,54.5,5,4,2,2,3,15,14,1
ENG-Premier League,2425,Crystal Palace,Odsonne Édouard,FRA,"MF,FW",27-128,1998,1.3,1,0,0,1,0,0,2,0.0,2,1,0,1,0,1,1,0
ENG-Premier League,2425,Crystal Palace,Romain Esse,ENG,MF,20-011,2005,1.4,8,6,4,2,2,5,5,100.0,0,2,0,2,1,9,2,0
ENG-Premier League,2425,Crystal Palace,Trevoh Chalobah,ENG,DF,25-323,1999,11.8,20,16,7,12,1,12,23,52.2,11,19,9,10,19,39,57,3
ENG-Premier League,2425,Crystal Palace,Tyrick Mitchell,ENG,DF,25-265,1999,33.4,88,54,55,26,7,23,43,53.5,20,63,12,51,14,102,100,2
ENG-Premier League,2425,Crystal Palace,Will Hughes,ENG,MF,30-037,1995,22.6,63,34,18,32,13,27,60,45.0,33,31,14,17,21,84,24,3
ENG-Premier League,2425,Everton,Abdoulaye Doucouré,MLI,MF,32-143,1993,28.3,48,28,21,20,7,14,43,32.6,29,31,6,25,10,58,19,1
ENG-Premier League,2425,Everton,Armando Broja,ALB,FW,23-256,2001,3.7,3,1,1,1,1,0,0,,0,3,0,3,1,4,4,0
ENG-Premier League,2425,Everton,Ashley Young,ENG,DF,39-319,1985,19.8,55,31,23,24,8,33,55,60.0,22,14,4,10,24,79,64,2
ENG-Premier League,2425,Everton,Beto,GNB,FW,27-113,1998,16.1,14,6,2,8,4,5,8,62.5,3,11,1,10,4,18,23,1
ENG-Premier League,2425,Everton,Carlos Alcaraz,ARG,"FW,MF",22-175,2002,7.7,11,5,5,3,3,3,9,33.3,6,7,1,6,4,15,10,0
ENG-Premier League,2425,Everton,Dominic Calvert-Lewin,ENG,FW,28-069,1997,17.8,9,7,1,4,4,2,6,33.3,4,7,2,5,7,16,22,0
ENG-Premier League,2425,Everton,Dwight McNeil,ENG,"MF,FW",25-183,1999,15.1,12,7,5,5,2,9,21,42.9,12,7,0,7,6,18,2,1
ENG-Premier League,2425,Everton,Harrison Armstrong,ENG,MF,18-125,2007,0.5,0,0,0,0,0,0,1,0.0,1,0,0,0,0,0,1,0
ENG-Premier League,2425,Everton,Idrissa Gana Gueye,SEN,MF,35-240,1989,33.0,133,80,61,55,17,58,99,58.6,41,48,9,39,45,178,34,1
ENG-Premier League,2425,Everton,Iliman Ndiaye,SEN,FW,25-079,2000,26.2,50,26,18,15,17,21,48,43.8,27,29,5,24,17,67,24,1
ENG-Premier League,2425,Everton,Jack Harrison,ENG,FW,28-185,1996,22.1,32,22,12,12,8,15,43,34.9,28,18,2,16,9,41,33,2
ENG-Premier League,2425,Everton,Jake O'Brien,IRL,DF,24-009,2001,16.5,24,16,19,5,0,16,24,66.7,8,17,4,13,4,28,85,0
ENG-Premier League,2425,Everton,James Garner,ENG,"MF,DF",24-072,2001,16.7,44,29,25,17,2,21,38,55.3,17,20,4,16,21,65,37,0
ENG-Premier League,2425,Everton,James Tarkowski,ENG,DF,32-186,1992,32.5,64,40,39,22,3,24,39,61.5,15,57,42,15,41,105,213,4
ENG-Premier League,2425,Everton,Jarrad Branthwaite,ENG,DF,22-331,2002,27.9,36,20,26,10,0,20,28,71.4,8,31,23,8,27,63,191,4
ENG-Premier League,2425,Everton,Jesper Lindstrøm,DEN,FW,25-084,2000,13.8,45,25,24,19,2,19,55,34.5,36,15,3,12,12,57,17,0
ENG-Premier League,2425,Everton,Jordan Pickford,ENG,GK,31-078,1994,37.0,1,0,1,0,0,1,2,50.0,1,0,0,0,1,2,29,2
ENG-Premier League,2425,Everton,Mason Holgate,ENG,"FW,DF",28-214,1996,0.1,0,0,0,0,0,0,0,,0,0,0,0,0,0,0,0
ENG-Premier League,2425,Everton,Michael Keane,ENG,DF,32-133,1993,10.7,12,9,8,2,2,8,15,53.3,7,12,8,4,15,27,61,2
ENG-Premier League,2425,Everton,Nathan Patterson,SCO,DF,23-220,2001,3.9,11,6,7,4,0,7,14,50.0,7,2,0,2,2,13,7,0
ENG-Premier League,2425,Everton,Orel Mangala,BEL,MF,27-067,1998,14.0,16,8,3,11,2,5,8,62.5,3,8,3,5,21,37,24,1
ENG-Premier League,2425,Everton,Roman Dixon,ENG,DF,20-149,2004,1.0,5,5,3,2,0,4,4,100.0,0,1,0,1,1,6,3,0
ENG-Premier League,2425,Everton,Séamus Coleman,IRL,DF,36-225,1988,2.4,3,2,2,1,0,3,4,75.0,1,5,3,2,1,4,8,0
ENG-Premier League,2425,Everton,Tim Iroegbunam,ENG,MF,21-328,2003,6.4,29,14,14,10,5,14,23,60.9,9,18,4,14,16,45,12,1
ENG-Premier League,2425,Everton,Vitaliy Mykolenko,UKR,DF,25-360,1999,33.2,62,38,39,14,9,29,56,51.8,27,25,10,15,42,104,142,2
ENG-Premier League,2425,Everton,Youssef Chermiti,POR,"FW,MF",21-000,2004,0.5,0,0,0,0,0,0,1,0.0,1,0,0,0,0,0,0,0
ENG-Premier League,2425,Fulham,Adama Traoré,ESP,"FW,MF",29-119,1996,18.9,19,13,8,6,5,5,13,38.5,8,7,0,7,1,20,6,4
ENG-Premier League,2425,Fulham,Alex Iwobi,NGA,"FW,MF",29-021,1996,32.8,43,24,14,21,8,21,33,63.6,12,26,1,25,13,56,29,1
ENG-Premier League,2425,Fulham,Andreas Pereira,BRA,MF,29-143,1996,21.7,23,13,7,11,5,10,41,24.4,31,16,2,14,8,31,17,3
ENG-Premier League,2425,Fulham,Antonee Robinson,USA,DF,27-289,1997,34.2,95,61,57,31,7,45,93,48.4,48,39,7,32,60,155,129,2
ENG-Premier League,2425,Fulham,Bernd Leno,GER,GK,33-081,1992,37.0,2,2,2,0,0,2,2,100.0,0,1,0,1,0,2,11,5
ENG-Premier League,2425,Fulham,Calvin Bassey,NGA,DF,25-144,1999,34.2,54,34,35,19,0,22,31,71.0,9,40,17,23,20,74,118,8
ENG-Premier League,2425,Fulham,Carlos Vinícius,BRA,"MF,FW",30-060,1995,0.2,0,0,0,0,0,0,1,0.0,1,1,0,1,0,0,0,0
ENG-Premier League,2425,Fulham,Emile Smith Rowe,ENG,MF,24-300,2000,22.4,31,18,7,14,10,8,24,33.3,16,22,2,20,11,42,16,0
ENG-Premier League,2425,Fulham,Harrison Reed,ENG,MF,30-117,1995,1.2,6,3,3,2,1,1,3,33.3,2,1,0,1,1,7,3,0
ENG-Premier League,2425,Fulham,Harry Wilson,WAL,"FW,MF",28-063,1997,12.2,17,12,11,3,3,10,16,62.5,6,14,1,13,6,23,9,1
ENG-Premier League,2425,Fulham,Issa Diop,FRA,DF,28-135,1997,14.9,26,12,18,8,0,13,18,72.2,5,10,7,3,9,35,72,2
ENG-Premier League,2425,Fulham,Jay Stansfield,ENG,MF,22-181,2002,0.0,0,0,0,0,0,0,0,,0,0,0,0,0,0,0,0
ENG-Premier League,2425,Fulham,Joachim Andersen,DEN,DF,28-358,1996,27.7,27,18,20,6,1,15,22,68.2,7,36,27,9,31,58,180,1
ENG-Premier League,2425,Fulham,Jorge Cuenca,ESP,DF,25-188,1999,2.9,2,2,2,0,0,2,5,40.0,3,3,3,0,2,4,21,0
ENG-Premier League,2425,Fulham,Joshua King,ENG,MF,18-141,2007,1.3,6,4,2,4,0,0,3,0.0,3,2,0,2,1,7,1,0
ENG-Premier League,2425,Fulham,Kenny Tete,NED,DF,29-227,1995,18.7,52,35,26,14,12,21,36,58.3,15,28,9,19,30,82,61,0
ENG-Premier League,2425,Fulham,Martial Godo,ENG,"FW,DF",22-071,2003,0.3,0,0,0,0,0,0,0,,0,1,0,1,1,1,0,0
ENG-Premier League,2425,Fulham,Raúl Jiménez,MEX,FW,34-019,1991,26.7,35,24,9,17,9,8,22,36.4,14,19,5,14,10,45,21,3
ENG-Premier League,2425,Fulham,Reiss Nelson,ENG,FW,25-165,1999,5.4,8,6,3,3,2,5,13,38.5,8,11,0,11,5,13,2,0
ENG-Premier League,2425,Fulham,Rodrigo Muniz,BRA,FW,24-020,2001,10.7,10,5,3,5,2,4,4,100.0,0,9,2,7,5,15,14,0
ENG-Premier League,2425,Fulham,Ryan Sessegnon,ENG,"FW,DF",25-006,2000,6.3,27,13,11,11,5,9,20,45.0,11,13,1,12,3,30,18,0
ENG-Premier League,2425,Fulham,Sander Berge,NOR,MF,27-099,1998,24.7,50,30,23,23,4,27,39,69.2,12,27,8,19,21,71,38,1
ENG-Premier League,2425,Fulham,Saša Lukić,SRB,MF,28-284,1996,25.1,67,38,21,40,6,22,54,40.7,32,20,7,13,26,93,33,1
ENG-Premier League,2425,Fulham,Timothy Castagne,BEL,DF,29-170,1995,18.3,46,29,28,15,3,26,45,57.8,19,15,6,9,22,68,83,0
ENG-Premier League,2425,Fulham,Tom Cairney,SCO,MF,34-124,1991,6.2,11,5,4,2,5,4,7,57.1,3,6,1,5,4,15,2,1
ENG-Premier League,2425,Fulham,Willian,BRA,"FW,MF",36-288,1988,2.9,4,2,0,3,1,2,6,33.3,4,0,0,0,1,5,1,0
ENG-Premier League,2425,Ipswich Town,Alex Palmer,ENG,GK,28-287,1996,13.0,0,0,0,0,0,0,0,,0,0,0,0,0,0,12,0
ENG-Premier League,2425,Ipswich Town,Ali Al Hamadi,IRQ,FW,23-084,2002,1.5,1,0,0,0,1,0,2,0.0,2,0,0,0,0,1,2,0
ENG-Premier League,2425,Ipswich Town,Arijanet Muric,KVX,GK,26-198,1998,18.0,0,0,0,0,0,0,2,0.0,2,0,0,0,0,0,10,5
ENG-Premier League,2425,Ipswich Town,Axel Tuanzebe,COD,DF,27-191,1997,18.0,31,19,21,4,6,17,26,65.4,9,20,10,10,23,54,54,1
ENG-Premier League,2425,Ipswich Town,Ben Godfrey,ENG,DF,27-129,1998,1.8,1,0,1,0,0,1,1,100.0,0,1,1,0,2,3,3,0
ENG-Premier League,2425,Ipswich Town,Ben Johnson,ENG,"DF,FW",25-120,2000,15.0,38,22,23,12,3,20,41,48.8,21,22,5,17,13,51,54,1
ENG-Premier League,2425,Ipswich Town,Cameron Burgess,AUS,DF,29-215,1995,17.1,17,12,14,3,0,9,11,81.8,2,20,15,5,14,31,128,3
ENG-Premier League,2425,Ipswich Town,Chiedozie Ogbene,IRL,FW,28-023,1997,2.6,7,3,1,2,4,2,4,50.0,2,1,0,1,1,8,3,0
ENG-Premier League,2425,Ipswich Town,Christian Walton,ENG,GK,29-196,1995,6.0,0,0,0,0,0,0,1,0.0,1,0,0,0,0,0,1,1
ENG-Premier League,2425,Ipswich Town,Conor Chaplin,ENG,"MF,FW",28-097,1997,8.8,14,5,5,6,3,6,13,46.2,7,8,1,7,3,17,3,0
ENG-Premier League,2425,Ipswich Town,Conor Townsend,ENG,DF,32-081,1993,3.7,11,8,9,2,0,8,11,72.7,3,8,6,2,4,15,16,0
ENG-Premier League,2425,Ipswich Town,Dara O'Shea,IRL,DF,26-081,1999,33.7,47,30,33,11,3,20,32,62.5,12,62,50,12,31,78,214,4
ENG-Premier League,2425,Ipswich Town,George Edmundson,ENG,DF,27-266,1997,0.0,0,0,0,0,0,0,0,,0,0,0,0,0,0,0,0
ENG-Premier League,2425,Ipswich Town,George Hirst,SCO,FW,26-098,1999,6.6,3,3,1,0,2,1,3,33.3,2,1,1,0,2,5,10,0
ENG-Premier League,2425,Ipswich Town,Harry Clarke,ENG,DF,24-083,2001,4.2,5,3,3,2,0,3,6,50.0,3,5,4,1,4,9,14,3
ENG-Premier League,2425,Ipswich Town,Jack Clarke,ENG,"FW,MF",24-182,2000,12.9,31,19,11,10,10,17,33,51.5,16,8,0,8,7,38,29,2
ENG-Premier League,2425,Ipswich Town,Jack Taylor,IRL,MF,26-335,1998,9.4,20,10,6,11,3,12,27,44.4,15,11,3,8,9,29,24,0
ENG-Premier League,2425,Ipswich Town,Jacob Greaves,ENG,DF,24-254,2000,23.5,39,21,20,17,2,22,34,64.7,12,39,25,14,20,59,139,3
ENG-Premier League,2425,Ipswich Town,Jaden Philogene Bidace,ENG,"FW,DF",23-105,2002,5.3,14,7,6,6,2,8,15,53.3,7,11,1,10,10,24,9,1
ENG-Premier League,2425,Ipswich Town,Jens Cajuste,SWE,MF,25-287,1999,20.9,42,20,19,22,1,21,49,42.9,28,24,9,15,25,67,33,2
ENG-Premier League,2425,Ipswich Town,Julio Enciso,PAR,"MF,FW",21-121,2004,9.7,12,9,3,6,3,4,11,36.4,7,8,1,7,1,13,6,0
ENG-Premier League,2425,Ipswich Town,Kalvin Phillips,ENG,MF,29-173,1995,13.7,35,19,8,20,7,15,39,38.5,24,35,6,29,19,54,37,2
ENG-Premier League,2425,Ipswich Town,Leif Davis,ENG,DF,25-132,2000,29.5,46,27,33,9,4,30,47,63.8,17,24,8,16,25,71,75,3
ENG-Premier League,2425,Ipswich Town,Liam Delap,ENG,FW,22-105,2003,28.6,11,8,3,3,5,2,14,14.3,12,8,0,8,2,13,28,0
ENG-Premier League,2425,Ipswich Town,Luke Woolfenden,ENG,DF,26-215,1998,13.2,9,6,5,4,0,2,5,40.0,3,21,14,7,19,28,76,0
ENG-Premier League,2425,Ipswich Town,Marcus Harness,ENG,MF,29-089,1996,0.5,1,0,0,0,1,0,3,0.0,3,2,1,1,0,1,1,0
ENG-Premier League,2425,Ipswich Town,Massimo Luongo,AUS,MF,32-241,1992,2.2,9,6,6,2,1,5,8,62.5,3,4,2,2,2,11,2,0
ENG-Premier League,2425,Ipswich Town,Nathan Broadhead,WAL,"MF,FW",27-049,1998,6.9,8,4,3,5,0,3,9,33.3,6,6,1,5,4,12,5,0
ENG-Premier League,2425,Ipswich Town,Omari Hutchinson,ENG,"MF,FW",21-206,2003,27.7,32,13,14,10,8,13,48,27.1,35,26,1,25,11,43,15,1
ENG-Premier League,2425,Ipswich Town,Sam Morsy,EGY,MF,33-256,1991,29.6,66,39,38,24,4,26,59,44.1,33,33,13,20,29,95,46,4
ENG-Premier League,2425,Ipswich Town,Sammie Szmodics,IRL,"FW,MF",29-242,1995,10.9,15,9,4,9,2,6,23,26.1,17,10,2,8,6,21,14,0
ENG-Premier League,2425,Ipswich Town,Wes Burns,WAL,"FW,DF",30-182,1994,10.3,13,11,1,9,3,4,10,40.0,6,7,2,5,10,23,13,2
ENG-Premier League,2425,Leicester City,Abdul Fatawu Issahaku,GHA,FW,21-077,2004,6.4,21,15,13,2,6,11,19,57.9,8,7,0,7,4,25,12,0
ENG-Premier League,2425,Leicester City,Bilal El Khannouss,MAR,"MF,FW",21-014,2004,24.2,50,30,16,29,5,17,32,53.1,15,22,4,18,6,56,10,3
ENG-Premier League,2425,Leicester City,Bobby De Cordova-Reid,JAM,FW,32-111,1993,8.3,9,4,3,6,0,4,14,28.6,10,6,1,5,0,9,10,0
ENG-Premier League,2425,Leicester City,Boubakary Soumaré,FRA,MF,26-086,1999,23.1,36,20,23,12,1,20,32,62.5,12,22,10,12,26,62,32,3
ENG-Premier League,2425,Leicester City,Caleb Okoli,ITA,DF,23-315,2001,12.5,25,14,8,15,2,11,18,61.1,7,24,14,10,15,40,79,3
ENG-Premier League,2425,Leicester City,Conor Coady,ENG,DF,32-088,1993,18.0,13,9,6,6,1,3,6,50.0,3,31,23,8,13,26,71,2
ENG-Premier League,2425,Leicester City,Danny Ward,WAL,GK,31-336,1993,1.5,0,0,0,0,0,0,0,,0,0,0,0,0,0,1,0
ENG-Premier League,2425,Leicester City,Facundo Buonanotte,ARG,"FW,MF",20-152,2004,16.7,53,32,17,22,14,21,67,31.3,46,33,6,27,12,65,14,0
ENG-Premier League,2425,Leicester City,Hamza Choudhury,BAN,"MF,DF",27-235,1997,1.5,1,1,1,0,0,1,3,33.3,2,4,2,2,5,6,2,0
ENG-Premier League,2425,Leicester City,Harry Winks,ENG,MF,29-111,1996,17.1,24,11,12,10,2,13,30,43.3,17,19,7,12,9,33,20,0
ENG-Premier League,2425,Leicester City,Jake Evans,,FW,,,0.2,1,1,0,0,1,0,1,0.0,1,0,0,0,0,1,1,0
ENG-Premier League,2425,Leicester City,Jakub Stolarczyk,POL,GK,24-156,2000,9.0,2,1,2,0,0,1,2,50.0,1,0,0,0,0,2,6,1
ENG-Premier League,2425,Leicester City,James Justin,ENG,DF,27-090,1998,31.4,53,32,27,21,5,31,54,57.4,23,45,16,29,45,98,134,3
ENG-Premier League,2425,Leicester City,Jamie Vardy,ENG,FW,38-133,1987,31.4,19,13,7,7,5,4,13,30.8,9,8,4,4,5,24,24,0
ENG-Premier League,2425,Leicester City,Jannik Vestergaard,DEN,DF,32-294,1992,15.5,22,10,16,6,0,9,15,60.0,6,21,14,7,16,38,74,1
ENG-Premier League,2425,Leicester City,Jeremy Monga,,"FW,MF",,,1.0,2,1,0,1,1,1,1,100.0,0,3,2,1,0,2,1,0
ENG-Premier League,2425,Leicester City,Jordan Ayew,GHA,"FW,MF",33-255,1991,17.2,27,15,8,14,5,7,21,33.3,14,20,1,19,12,39,19,0
ENG-Premier League,2425,Leicester City,Kasey McAteer,IRL,"FW,MF",23-183,2001,8.5,19,15,10,6,3,11,25,44.0,14,18,2,16,4,23,15,0
ENG-Premier League,2425,Leicester City,Luke Thomas,ENG,DF,23-348,2001,11.5,30,24,23,5,2,21,39,53.8,18,14,6,8,21,51,43,1
ENG-Premier League,2425,Leicester City,Mads Hermansen,DEN,GK,24-317,2000,26.5,1,1,1,0,0,1,1,100.0,0,1,0,1,0,1,13,4
ENG-Premier League,2425,Leicester City,Michael Golding,ENG,MF,19-001,2006,0.0,0,0,0,0,0,0,0,,0,0,0,0,0,0,0,0
ENG-Premier League,2425,Leicester City,Odsonne Édouard,FRA,FW,27-128,1998,0.3,1,1,1,0,0,0,0,,0,0,0,0,0,1,1,0
ENG-Premier League,2425,Leicester City,Oliver Skipp,ENG,MF,24-250,2000,11.8,20,4,5,12,3,9,15,60.0,6,19,6,13,10,30,11,2
ENG-Premier League,2425,Leicester City,Patson Daka,ZAM,"FW,MF",26-227,1998,7.4,18,9,5,9,4,7,17,41.2,10,7,1,6,1,19,10,0
ENG-Premier League,2425,Leicester City,Ricardo Pereira,POR,DF,31-230,1993,4.1,12,7,4,5,3,7,13,53.8,6,8,3,5,4,16,11,0
ENG-Premier League,2425,Leicester City,Stephy Mavididi,ENG,FW,26-358,1998,17.9,34,19,16,10,8,14,42,33.3,28,26,2,24,11,45,15,0
ENG-Premier League,2425,Leicester City,Victor Bernth Kristiansen,DEN,DF,22-159,2002,26.6,85,50,54,26,5,47,87,54.0,40,37,14,23,40,125,72,3
ENG-Premier League,2425,Leicester City,Wilfred Ndidi,NGA,MF,28-159,1996,25.8,85,51,45,32,8,30,61,49.2,31,47,19,28,31,116,80,0
ENG-Premier League,2425,Leicester City,Will Alves,ENG,FW,20-110,2005,0.0,0,0,0,0,0,0,0,,0,0,0,0,0,0,0,0
ENG-Premier League,2425,Leicester City,Wout Faes,BEL,DF,27-051,1998,30.3,41,25,26,13,2,24,46,52.2,22,46,34,12,26,67,174,4
ENG-Premier League,2425,Leicester City,Woyo Coulibaly,FRA,DF,26-004,1999,1.2,6,4,4,2,0,2,2,100.0,0,3,1,2,5,11,1,0
ENG-Premier League,2425,Liverpool,Alexis Mac Allister,ARG,MF,26-151,1998,28.9,95,58,28,51,16,55,104,52.9,49,61,6,55,22,117,29,1
ENG-Premier League,2425,Liverpool,Alisson,BRA,GK,32-234,1992,26.9,1,0,1,0,0,0,1,0.0,1,0,0,0,0,1,13,1
ENG-Premier League,2425,Liverpool,Andrew Robertson,SCO,DF,31-074,1994,26.6,39,22,25,10,4,31,50,62.0,19,10,4,6,21,60,53,2
ENG-Premier League,2425,Liverpool,Caoimhín Kelleher,IRL,GK,26-182,1998,10.0,0,0,0,0,0,0,0,,0,0,0,0,0,0,1,2
ENG-Premier League,2425,Liverpool,Cody Gakpo,NED,FW,26-017,1999,20.5,27,15,5,13,9,12,24,50.0,12,23,3,20,12,39,18,1
ENG-Premier League,2425,Liverpool,Conor Bradley,NIR,DF,21-319,2003,7.9,13,10,7,4,2,10,21,47.6,11,8,2,6,4,17,30,0
ENG-Premier League,2425,Liverpool,Curtis Jones,ENG,"MF,DF",24-114,2001,18.0,37,21,6,22,9,17,26,65.4,9,20,9,11,7,44,8,3
ENG-Premier League,2425,Liverpool,Darwin Núñez,URU,FW,25-334,1999,12.3,20,17,11,3,6,6,17,35.3,11,6,0,6,3,23,12,0
ENG-Premier League,2425,Liverpool,Diogo Jota,POR,FW,28-171,1996,13.0,14,8,2,8,4,7,19,36.8,12,9,0,9,7,21,6,0
ENG-Premier League,2425,Liverpool,Dominik Szoboszlai,HUN,MF,24-211,2000,27.0,37,20,14,18,5,17,41,41.5,24,37,4,33,9,46,19,2
ENG-Premier League,2425,Liverpool,Federico Chiesa,ITA,FW,27-211,1997,1.2,1,0,0,1,0,0,2,0.0,2,1,0,1,0,1,1,1
ENG-Premier League,2425,Liverpool,Harvey Elliott,ENG,"MF,FW",22-050,2003,4.1,5,3,3,1,1,2,8,25.0,6,7,2,5,1,6,3,1
ENG-Premier League,2425,Liverpool,Ibrahima Konaté,FRA,DF,25-364,1999,27.8,38,26,25,11,2,24,34,70.6,10,29,15,14,14,52,131,3
ENG-Premier League,2425,Liverpool,Jarell Quansah,ENG,DF,22-115,2003,5.5,12,8,8,4,0,7,10,70.0,3,10,7,3,7,19,28,1
ENG-Premier League,2425,Liverpool,Jayden Danns,ENG,MF,19-128,2006,0.1,0,0,0,0,0,0,1,0.0,1,0,0,0,0,0,0,0
ENG-Premier League,2425,Liverpool,Joe Gomez,ENG,DF,28-001,1997,5.8,13,10,5,7,1,11,16,68.8,5,9,6,3,7,20,20,2
ENG-Premier League,2425,Liverpool,Kostas Tsimikas,GRE,DF,29-012,1996,9.3,31,20,15,11,5,14,23,60.9,9,5,2,3,11,42,20,0
ENG-Premier League,2425,Liverpool,Luis Díaz,COL,FW,28-131,1997,25.9,35,23,11,18,6,13,37,35.1,24,19,0,19,7,42,7,1
ENG-Premier League,2425,Liverpool,Mohamed Salah,EGY,FW,32-343,1992,36.5,21,11,7,5,9,8,17,47.1,9,11,0,11,8,29,5,0
ENG-Premier League,2425,Liverpool,Ryan Gravenberch,NED,MF,23-008,2002,34.4,67,35,27,29,11,32,55,58.2,23,35,10,25,59,126,59,2
ENG-Premier League,2425,Liverpool,Trent Alexander-Arnold,ENG,DF,26-229,1998,25.8,71,50,43,19,9,48,103,46.6,55,26,9,17,31,102,54,4
ENG-Premier League,2425,Liverpool,Virgil van Dijk,NED,DF,33-320,1991,36.0,35,17,17,16,2,11,20,55.0,9,27,16,11,54,89,184,4
ENG-Premier League,2425,Liverpool,Vitezslav Jaros,CZE,GK,23-305,2001,0.1,0,0,0,0,0,0,0,,0,0,0,0,0,0,0,0
ENG-Premier League,2425,Liverpool,Wataru Endo,JPN,"MF,DF",32-104,1993,2.8,11,8,6,5,0,6,10,60.0,4,7,1,6,3,14,8,0
ENG-Premier League,2425,Manchester City,Abdukodir Khusanov,UZB,DF,21-084,2004,5.6,5,4,4,1,0,2,3,66.7,1,5,4,1,3,8,29,1
ENG-Premier League,2425,Manchester City,Bernardo Silva,POR,"MF,FW",30-287,1994,28.7,54,35,15,30,9,25,54,46.3,29,36,7,29,21,75,32,3
ENG-Premier League,2425,Manchester City,Divin Mubama,ENG,FW,20-211,2004,0.3,0,0,0,0,0,0,0,,0,0,0,0,0,0,0,0
ENG-Premier League,2425,Manchester City,Ederson,BRA,GK,31-280,1993,24.8,0,0,0,0,0,0,2,0.0,2,0,0,0,1,1,10,3
ENG-Premier League,2425,Manchester City,Erling Haaland,NOR,FW,24-307,2000,29.5,11,6,3,3,5,3,7,42.9,4,12,1,11,5,16,23,0
ENG-Premier League,2425,Manchester City,Jack Grealish,ENG,"FW,MF",29-256,1995,8.0,9,5,4,2,3,2,5,40.0,3,12,2,10,2,11,6,1
ENG-Premier League,2425,Manchester City,Jahmai Simpson-Pusey,ENG,DF,19-201,2005,1.1,1,0,1,0,0,0,1,0.0,1,1,1,0,0,1,2,0
ENG-Premier League,2425,Manchester City,James Mcatee,ENG,"MF,FW",22-218,2002,3.9,5,2,0,4,1,1,7,14.3,6,8,0,8,2,7,1,0
ENG-Premier League,2425,Manchester City,Jeremy Doku,BEL,"FW,MF",22-362,2002,16.0,30,21,9,12,9,8,15,53.3,7,10,1,9,4,34,2,0
ENG-Premier League,2425,Manchester City,John Stones,ENG,"DF,MF",30-361,1994,6.1,6,2,3,2,1,5,5,100.0,0,5,3,2,4,10,19,1
ENG-Premier League,2425,Manchester City,Joško Gvardiol,CRO,DF,23-121,2002,35.4,56,37,25,19,12,20,38,52.6,18,42,20,22,41,97,121,8
ENG-Premier League,2425,Manchester City,Kevin De Bruyne,BEL,"MF,FW",33-330,1991,18.8,17,9,7,5,5,5,23,21.7,18,8,0,8,7,24,10,1
ENG-Premier League,2425,Manchester City,Kyle Walker,ENG,DF,34-361,1990,10.8,17,10,7,7,3,14,26,53.8,12,13,4,9,3,20,13,1
ENG-Premier League,2425,Manchester City,Manuel Akanji,SUI,DF,29-309,1995,21.4,18,11,11,4,3,10,16,62.5,6,11,8,3,7,25,63,3
ENG-Premier League,2425,Manchester City,Mateo Kovačić,CRO,MF,31-018,1994,24.4,69,38,23,38,8,31,65,47.7,34,20,0,20,24,93,21,1
ENG-Premier League,2425,Manchester City,Matheus Nunes,POR,"DF,MF",26-270,1998,17.6,33,21,14,13,6,15,35,42.9,20,16,4,12,14,47,37,2
ENG-Premier League,2425,Manchester City,Nathan Aké,NED,DF,30-095,1995,7.5,9,7,7,2,0,4,6,66.7,2,7,2,5,3,12,22,1
ENG-Premier League,2425,Manchester City,Nico O’Reilly,ENG,DF,20-064,2005,5.9,9,4,3,3,3,4,8,50.0,4,5,1,4,4,13,12,0
ENG-Premier League,2425,Manchester City,Nicolás González,ESP,MF,23-141,2002,7.4,15,6,5,6,4,6,11,54.5,5,9,0,9,6,21,18,0
ENG-Premier League,2425,Manchester City,Omar Marmoush,EGY,"FW,MF",26-106,1999,12.2,11,6,2,7,2,7,15,46.7,8,15,1,14,5,16,3,0
ENG-Premier League,2425,Manchester City,Oscar Bobb,NOR,FW,21-316,2003,0.2,0,0,0,0,0,0,0,,0,0,0,0,0,0,0,0
ENG-Premier League,2425,Manchester City,Phil Foden,ENG,"MF,FW",24-361,2000,19.6,12,5,5,4,3,7,18,38.9,11,13,1,12,9,21,7,1
ENG-Premier League,2425,Manchester City,Rico Lewis,ENG,"DF,MF",20-184,2004,21.0,30,19,13,12,5,13,21,61.9,8,28,7,21,13,43,45,1
ENG-Premier League,2425,Manchester City,Rodri,ESP,MF,28-336,1996,0.8,2,1,1,1,0,0,0,,0,1,0,1,1,3,1,0
ENG-Premier League,2425,Manchester City,Rúben Dias,POR,DF,28-010,1997,24.2,17,11,7,9,1,7,12,58.3,5,20,17,3,18,35,64,4
ENG-Premier League,2425,Manchester City,Stefan Ortega,GER,GK,32-199,1992,12.2,0,0,0,0,0,0,1,0.0,1,0,0,0,0,0,11,1
ENG-Premier League,2425,Manchester City,Sávio,BRA,"FW,MF",21-044,2004,19.4,23,17,5,10,8,10,19,52.6,9,14,2,12,6,29,9,1
ENG-Premier League,2425,Manchester City,Vitor Reis,BRA,DF,19-132,2006,0.0,0,0,0,0,0,0,0,,0,0,0,0,0,0,1,0
ENG-Premier League,2425,Manchester City,İlkay Gündoğan,GER,MF,34-212,1990,23.8,24,13,4,15,5,10,24,41.7,14,15,0,15,13,37,23,0
ENG-Premier League,2425,Manchester Utd,Alejandro Garnacho,ARG,"MF,FW",20-327,2004,24.4,30,18,11,6,13,12,37,32.4,25,19,0,19,13,43,11,2
ENG-Premier League,2425,Manchester Utd,Altay Bayındır,TUR,GK,27-040,1998,3.0,0,0,0,0,0,0,1,0.0,1,0,0,0,0,0,6,1
ENG-Premier League,2425,Manchester Utd,Amad Diallo,CIV,"MF,FW",22-317,2002,20.1,36,29,7,20,9,18,30,60.0,12,13,1,12,11,47,18,0
ENG-Premier League,2425,Manchester Utd,André Onana,CMR,GK,29-052,1996,34.0,2,2,2,0,0,2,4,50.0,2,0,0,0,0,2,11,4
ENG-Premier League,2425,Manchester Utd,Antony,BRA,"DF,MF",25-089,2000,1.6,6,3,4,2,0,2,5,40.0,3,2,0,2,2,8,0,0
ENG-Premier League,2425,Manchester Utd,Ayden Heaven,ENG,DF,18-244,2006,1.2,3,3,1,2,0,2,2,100.0,0,2,2,0,1,4,6,0
ENG-Premier League,2425,Manchester Utd,Bruno Fernandes,POR,MF,30-258,1994,32.5,79,47,26,37,16,31,81,38.3,50,35,6,29,26,105,35,3
ENG-Premier League,2425,Manchester Utd,Casemiro,BRA,MF,33-090,1992,15.6,80,48,47,23,10,43,69,62.3,26,37,10,27,13,93,50,3
ENG-Premier League,2425,Manchester Utd,Chidozie Obi-Martin,DEN,FW,17-176,2007,1.7,2,1,0,0,2,2,2,100.0,0,0,0,0,0,2,1,0
ENG-Premier League,2425,Manchester Utd,Christian Eriksen,DEN,MF,33-099,1992,11.5,19,9,4,12,3,11,26,42.3,15,14,4,10,7,26,7,0
ENG-Premier League,2425,Manchester Utd,Diogo Dalot,POR,DF,26-067,1999,31.0,67,39,39,22,6,34,52,65.4,18,22,9,13,37,104,72,0
ENG-Premier League,2425,Manchester Utd,Harry Amass,ENG,DF,18-069,2007,3.8,6,2,5,1,0,2,8,25.0,6,11,1,10,2,8,11,0
ENG-Premier League,2425,Manchester Utd,Harry Maguire,ENG,DF,32-080,1993,18.5,28,14,22,5,1,15,21,71.4,6,15,12,3,40,68,75,1
ENG-Premier League,2425,Manchester Utd,Jonny Evans,NIR,DF,37-141,1988,3.2,7,5,4,3,0,2,4,50.0,2,2,1,1,4,11,13,0
ENG-Premier League,2425,Manchester Utd,Joshua Zirkzee,NED,"FW,MF",24-002,2001,15.6,14,8,3,8,3,5,10,50.0,5,15,4,11,6,20,8,1
ENG-Premier League,2425,Manchester Utd,Kobbie Mainoo,ENG,MF,20-035,2005,17.8,45,28,18,14,13,24,39,61.5,15,16,2,14,19,64,14,1
ENG-Premier League,2425,Manchester Utd,Leny Yoro,FRA,DF,19-192,2005,12.9,29,11,19,9,1,13,19,68.4,6,5,3,2,18,47,43,0
ENG-Premier League,2425,Manchester Utd,Lisandro Martínez,ARG,DF,27-126,1998,19.5,40,24,25,12,3,21,36,58.3,15,22,8,14,32,72,57,1
ENG-Premier League,2425,Manchester Utd,Luke Shaw,ENG,DF,29-316,1995,3.9,4,3,2,2,0,2,2,100.0,0,6,1,5,2,6,7,0
ENG-Premier League,2425,Manchester Utd,Manuel Ugarte Ribeiro,URU,MF,24-043,2001,19.8,77,49,34,34,9,30,68,44.1,38,33,4,29,27,104,17,2
ENG-Premier League,2425,Manchester Utd,Marcus Rashford,ENG,"FW,MF",27-205,1997,10.9,7,4,2,2,3,3,9,33.3,6,8,0,8,4,11,7,0
ENG-Premier League,2425,Manchester Utd,Mason Mount,ENG,MF,26-134,1999,6.2,15,5,5,8,2,9,11,81.8,2,11,1,10,4,19,3,0
ENG-Premier League,2425,Manchester Utd,Matthijs de Ligt,NED,DF,25-285,1999,23.6,30,22,17,12,1,23,32,71.9,9,29,21,8,33,63,96,0
ENG-Premier League,2425,Manchester Utd,Noussair Mazraoui,MAR,DF,27-191,1997,31.3,112,65,57,41,14,58,93,62.4,35,36,9,27,34,146,94,1
ENG-Premier League,2425,Manchester Utd,Patrick Dorgu,DEN,DF,20-210,2004,8.4,30,23,15,13,2,16,23,69.6,7,10,0,10,4,34,21,2
ENG-Premier League,2425,Manchester Utd,Rasmus Højlund,DEN,FW,22-109,2003,21.4,3,1,0,2,1,0,4,0.0,4,6,0,6,1,4,6,0
ENG-Premier League,2425,Manchester Utd,Scott McTominay,SCO,MF,28-167,1996,0.2,0,0,0,0,0,0,1,0.0,1,0,0,0,0,0,1,0
ENG-Premier League,2425,Manchester Utd,Toby Collyer,ENG,MF,21-141,2004,2.0,12,9,6,6,0,5,6,83.3,1,2,1,1,2,14,3,0
ENG-Premier League,2425,Manchester Utd,Tyler Fredricson,ENG,DF,20-090,2005,1.8,5,3,3,2,0,1,2,50.0,1,2,0,2,1,6,11,0
ENG-Premier League,2425,Manchester Utd,Tyrell Malacia,NED,DF,25-280,1999,1.1,2,1,2,0,0,1,2,50.0,1,0,0,0,1,3,1,1
ENG-Premier League,2425,Manchester Utd,Victor Lindelöf,SWE,DF,30-311,1994,6.8,7,2,5,1,1,3,4,75.0,1,6,4,2,7,14,35,2
ENG-Premier League,2425,Newcastle Utd,Alexander Isak,SWE,FW,25-245,1999,29.6,12,5,2,3,7,5,15,33.3,10,18,2,16,3,15,17,1
ENG-Premier League,2425,Newcastle Utd,Anthony Gordon,ENG,"FW,MF",24-089,2001,26.5,32,18,9,18,5,12,35,34.3,23,25,2,23,6,38,9,3
ENG-Premier League,2425,Newcastle Utd,Bruno Guimarães,BRA,MF,27-189,1997,35.3,82,46,41,29,12,33,68,48.5,35,35,10,25,28,110,44,4
ENG-Premier League,2425,Newcastle Utd,Callum Wilson,ENG,FW,33-086,1992,3.9,2,2,0,1,1,0,2,0.0,2,2,0,2,1,3,1,0
ENG-Premier League,2425,Newcastle Utd,Dan Burn,ENG,DF,33-015,1992,36.0,38,23,22,14,2,20,36,55.6,16,34,24,10,26,64,189,3
ENG-Premier League,2425,Newcastle Utd,Emil Krafth,SWE,DF,30-295,1994,3.8,4,2,2,1,1,2,3,66.7,1,5,4,1,2,6,16,0
ENG-Premier League,2425,Newcastle Utd,Fabian Schär,SUI,DF,33-155,1991,31.6,35,21,16,17,2,14,34,41.2,20,38,25,13,44,79,136,3
ENG-Premier League,2425,Newcastle Utd,Harvey Barnes,ENG,FW,27-166,1997,18.5,16,9,4,6,6,3,11,27.3,8,8,2,6,6,22,14,1
ENG-Premier League,2425,Newcastle Utd,Jacob Murphy,ENG,FW,30-089,1995,25.5,28,19,10,12,6,20,43,46.5,23,31,0,31,12,40,35,1
ENG-Premier League,2425,Newcastle Utd,Joe Willock,ENG,"MF,FW",25-277,1999,11.6,29,16,15,11,3,18,29,62.1,11,24,6,18,6,35,7,0
ENG-Premier League,2425,Newcastle Utd,Joelinton,BRA,"MF,FW",28-283,1996,26.6,57,35,23,23,11,25,44,56.8,19,37,7,30,23,80,47,2
ENG-Premier League,2425,Newcastle Utd,Kieran Trippier,ENG,DF,34-247,1990,14.2,37,20,18,13,6,21,35,60.0,14,11,3,8,12,49,49,0
ENG-Premier League,2425,Newcastle Utd,Lewis Hall,ENG,DF,20-258,2004,24.3,58,41,28,22,8,40,74,54.1,34,33,18,15,18,76,75,3
ENG-Premier League,2425,Newcastle Utd,Lewis Miley,ENG,MF,19-023,2006,3.5,14,11,5,7,2,7,14,50.0,7,5,1,4,2,16,5,2
ENG-Premier League,2425,Newcastle Utd,Lloyd Kelly,ENG,DF,26-230,1998,3.4,5,4,4,1,0,1,1,100.0,0,6,4,2,1,6,17,0
ENG-Premier League,2425,Newcastle Utd,Martin Dúbravka,SVK,GK,36-129,1989,10.0,0,0,0,0,0,0,0,,0,0,0,0,0,0,3,0
ENG-Premier League,2425,Newcastle Utd,Matt Targett,ENG,DF,29-248,1995,0.2,0,0,0,0,0,0,1,0.0,1,0,0,0,1,1,1,0
ENG-Premier League,2425,Newcastle Utd,Miguel Almirón,PAR,FW,31-103,1994,1.7,3,2,2,0,1,2,3,66.7,1,2,0,2,0,3,0,0
ENG-Premier League,2425,Newcastle Utd,Nick Pope,ENG,GK,33-035,1992,27.0,0,0,0,0,0,0,0,,0,1,0,1,1,1,31,5
ENG-Premier League,2425,Newcastle Utd,Sandro Tonali,ITA,MF,25-016,2000,28.2,49,31,21,23,5,24,48,50.0,24,33,11,22,34,83,33,2
ENG-Premier League,2425,Newcastle Utd,Sean Longstaff,ENG,MF,27-206,1997,8.9,27,16,10,9,8,18,27,66.7,9,17,5,12,7,34,8,0
ENG-Premier League,2425,Newcastle Utd,Sven Botman,NED,DF,25-132,2000,3.9,8,6,4,4,0,4,6,66.7,2,5,4,1,5,13,20,0
ENG-Premier League,2425,Newcastle Utd,Valentino Livramento,ENG,DF,22-193,2002,30.6,54,36,35,15,4,32,59,54.2,27,37,11,26,23,77,104,1
ENG-Premier League,2425,Newcastle Utd,William Osula,DEN,FW,21-293,2003,1.5,2,0,1,0,1,0,2,0.0,2,0,0,0,4,6,2,0
ENG-Premier League,2425,Nott'ham Forest,Anthony Elanga,SWE,"FW,MF",23-027,2002,26.8,19,14,8,8,3,5,17,29.4,12,11,1,10,6,25,25,0
ENG-Premier League,2425,Nott'ham Forest,Callum Hudson-Odoi,ENG,"FW,MF",24-198,2000,24.0,22,14,8,8,6,12,18,66.7,6,11,0,11,13,35,12,1
ENG-Premier League,2425,Nott'ham Forest,Chris Wood,NZL,FW,33-168,1991,31.9,6,5,2,2,2,3,11,27.3,8,12,7,5,5,11,28,1
ENG-Premier League,2425,Nott'ham Forest,Danilo,BRA,"MF,FW",24-025,2001,3.1,8,4,7,1,0,3,6,50.0,3,2,1,1,4,12,3,0
ENG-Premier League,2425,Nott'ham Forest,Elliot Anderson,ENG,MF,22-199,2002,29.3,91,55,54,28,9,48,110,43.6,62,45,9,36,31,122,73,4
ENG-Premier League,2425,Nott'ham Forest,Eric da Silva Moreira,GER,"MF,DF",19-021,2006,0.3,2,2,2,0,0,2,6,33.3,4,0,0,0,1,3,0,0
ENG-Premier League,2425,Nott'ham Forest,Harry Toffolo,ENG,DF,29-278,1995,1.5,5,3,3,1,1,3,4,75.0,1,2,2,0,2,7,12,0
ENG-Premier League,2425,Nott'ham Forest,Ibrahim Sangaré,CIV,MF,27-173,1997,5.9,25,13,7,15,3,6,15,40.0,9,9,4,5,6,31,11,1
ENG-Premier League,2425,Nott'ham Forest,James Ward-Prowse,ENG,MF,30-204,1994,4.4,4,1,1,3,0,2,2,100.0,0,3,2,1,5,9,8,0
ENG-Premier League,2425,Nott'ham Forest,Jota Silva,POR,"FW,MF",25-296,1999,9.4,27,14,12,13,2,6,26,23.1,20,9,1,8,12,39,17,0
ENG-Premier League,2425,Nott'ham Forest,Matz Sels,BEL,GK,33-087,1992,37.0,1,1,1,0,0,1,1,100.0,0,0,0,0,0,1,25,1
ENG-Premier League,2425,Nott'ham Forest,Morato,BRA,DF,23-328,2001,10.1,22,14,18,3,1,13,21,61.9,8,14,5,9,10,32,78,2
ENG-Premier League,2425,Nott'ham Forest,Morgan Gibbs-White,ENG,MF,25-117,2000,30.1,42,21,14,22,6,16,32,50.0,16,18,5,13,23,65,28,1
ENG-Premier League,2425,Nott'ham Forest,Murillo,BRA,DF,22-324,2002,34.4,53,36,38,12,3,27,46,58.7,19,68,45,23,35,88,246,3
ENG-Premier League,2425,Nott'ham Forest,Neco Williams,WAL,DF,24-041,2001,27.8,87,55,63,18,6,51,82,62.2,31,42,10,32,29,116,135,2
ENG-Premier League,2425,Nott'ham Forest,Nicolás Domínguez,ARG,"MF,FW",26-330,1998,21.1,84,43,38,35,11,34,74,45.9,40,37,11,26,29,113,54,1
ENG-Premier League,2425,Nott'ham Forest,Nikola Milenković,SRB,DF,27-224,1997,36.0,48,28,34,12,2,26,33,78.8,7,40,24,16,27,75,203,1
ENG-Premier League,2425,Nott'ham Forest,Ola Aina,NGA,DF,28-228,1996,32.4,54,41,39,14,1,35,63,55.6,28,33,12,21,33,87,112,4
ENG-Premier League,2425,Nott'ham Forest,Ramón Sosa,PAR,"FW,MF",25-266,1999,3.3,5,3,3,0,2,1,5,20.0,4,9,0,9,4,9,5,0
ENG-Premier League,2425,Nott'ham Forest,Ryan Yates,ENG,MF,27-184,1997,21.0,42,21,24,14,4,17,37,45.9,20,36,9,27,26,68,61,1
ENG-Premier League,2425,Nott'ham Forest,Taiwo Awoniyi,NGA,FW,27-285,1997,4.6,6,3,0,3,3,4,5,80.0,1,1,0,1,0,6,7,0
ENG-Premier League,2425,Nott'ham Forest,Willy Boly,CIV,DF,34-110,1991,1.7,6,1,5,1,0,4,4,100.0,0,4,2,2,3,9,12,0
ENG-Premier League,2425,Nott'ham Forest,Álex Moreno,ESP,"DF,MF",31-350,1993,10.6,25,18,20,5,0,15,39,38.5,24,11,5,6,15,40,43,0
ENG-Premier League,2425,Southampton,Aaron Ramsdale,ENG,GK,27-010,1998,29.0,0,0,0,0,0,0,3,0.0,3,0,0,0,2,2,10,3
ENG-Premier League,2425,Southampton,Adam Armstrong,ENG,"FW,MF",28-103,1997,13.9,12,3,2,7,3,3,14,21.4,11,6,1,5,3,15,8,0
ENG-Premier League,2425,Southampton,Adam Lallana,ENG,MF,37-014,1988,4.0,8,5,4,4,0,2,12,16.7,10,4,1,3,5,13,5,0
ENG-Premier League,2425,Southampton,Albert Grønbaek,DEN,"FW,MF",24-001,2001,1.6,4,1,1,1,2,3,10,30.0,7,1,1,0,0,4,1,0
ENG-Premier League,2425,Southampton,Alex McCarthy,ENG,GK,35-172,1989,5.0,0,0,0,0,0,0,0,,0,0,0,0,0,0,1,4
ENG-Premier League,2425,Southampton,Armel Bella Kotchap,GER,DF,23-164,2001,3.7,7,5,5,2,0,3,6,50.0,3,2,2,0,5,12,21,1
ENG-Premier League,2425,Southampton,Ben Brereton,CHI,FW,26-036,1999,5.0,3,2,0,2,1,1,9,11.1,8,2,1,1,0,3,4,0
ENG-Premier League,2425,Southampton,Cameron Archer,ENG,FW,23-307,2001,15.9,11,7,6,3,2,2,9,22.2,7,5,1,4,2,13,10,0
ENG-Premier League,2425,Southampton,Carlos Alcaraz,ARG,MF,22-175,2002,0.1,0,0,0,0,0,0,0,,0,0,0,0,1,1,0,0
ENG-Premier League,2425,Southampton,Charlie Taylor,ENG,DF,31-248,1993,3.0,7,5,4,3,0,5,6,83.3,1,5,3,2,3,10,22,1
ENG-Premier League,2425,Southampton,Flynn Downes,ENG,MF,26-124,1999,22.9,48,25,23,20,5,15,36,41.7,21,24,6,18,31,79,49,4
ENG-Premier League,2425,Southampton,Jack Stephens,ENG,DF,31-117,1994,15.4,34,20,25,9,0,17,30,56.7,13,20,13,7,13,47,53,2
ENG-Premier League,2425,Southampton,James Bree,ENG,DF,27-225,1997,11.9,19,14,8,10,1,10,25,40.0,15,10,3,7,9,28,29,0
ENG-Premier League,2425,Southampton,Jan Bednarek,POL,DF,29-042,1996,28.1,36,19,23,13,0,16,31,51.6,15,47,36,11,56,92,190,5
ENG-Premier League,2425,Southampton,Jay Robinson,ENG,"FW,MF",18-070,2007,0.7,3,1,2,0,1,0,0,,0,0,0,0,0,3,1,0
ENG-Premier League,2425,Southampton,Joachim Kayi Sanda,FRA,DF,18-176,2006,0.1,0,0,0,0,0,0,0,,0,0,0,0,2,2,0,0
ENG-Premier League,2425,Southampton,Joe Aribo,NGA,"MF,DF",28-307,1996,22.4,47,33,17,24,6,17,35,48.6,18,28,11,17,20,67,32,3
ENG-Premier League,2425,Southampton,Joe Lumley,ENG,GK,30-098,1995,3.0,0,0,0,0,0,0,0,,0,0,0,0,0,0,3,3
ENG-Premier League,2425,Southampton,Kamaldeen Sulemana,GHA,"FW,MF",23-098,2002,14.7,19,16,6,5,8,9,14,64.3,5,13,3,10,6,25,9,0
ENG-Premier League,2425,Southampton,Kyle Walker-Peters,ENG,DF,28-041,1997,32.4,44,29,22,15,7,16,35,45.7,19,27,15,12,19,63,90,1
ENG-Premier League,2425,Southampton,Lesley Ugochukwu,FRA,MF,21-059,2004,17.4,49,24,15,30,4,18,35,51.4,17,27,10,17,14,63,21,1
ENG-Premier League,2425,Southampton,Mateus Fernandes,POR,MF,20-318,2004,31.3,88,47,45,28,15,33,67,49.3,34,41,7,34,26,114,35,7
ENG-Premier League,2425,Southampton,Maxwel Cornet,CIV,FW,28-239,1996,0.8,5,5,1,4,0,0,4,0.0,4,0,0,0,0,5,2,0
ENG-Premier League,2425,Southampton,Nathan Wood-Gordon,ENG,DF,22-358,2002,7.6,11,7,7,3,1,6,9,66.7,3,8,5,3,5,16,32,2
ENG-Premier League,2425,Southampton,Paul Onuachu,NGA,FW,30-361,1994,11.4,7,2,1,5,1,3,7,42.9,4,7,2,5,1,8,16,1
ENG-Premier League,2425,Southampton,Ronnie Edwards,ENG,DF,22-057,2003,0.1,0,0,0,0,0,0,0,,0,1,1,0,0,0,0,0
ENG-Premier League,2425,Southampton,Ross Stewart,SCO,FW,28-317,1996,3.6,4,3,1,0,3,2,6,33.3,4,3,0,3,1,5,6,0
ENG-Premier League,2425,Southampton,Ryan Fraser,SCO,"FW,DF",31-089,1994,3.4,6,2,2,4,0,4,6,66.7,2,1,1,0,1,7,9,0
ENG-Premier League,2425,Southampton,Ryan Manning,IRL,"DF,MF",28-344,1996,16.2,28,17,16,10,2,14,26,53.8,12,20,11,9,17,45,47,0
ENG-Premier League,2425,Southampton,Samuel Amo-Ameyaw,ENG,"FW,DF",18-310,2006,0.3,1,0,0,1,0,1,1,100.0,0,0,0,0,0,1,0,0
ENG-Premier League,2425,Southampton,Samuel Edozie,ENG,"DF,FW",22-116,2003,0.7,3,1,0,1,2,2,2,100.0,0,0,0,0,0,3,0,0
ENG-Premier League,2425,Southampton,Taylor Harwood-Bellis,ENG,DF,23-114,2002,31.4,28,20,13,12,3,19,35,54.3,16,65,43,22,30,58,141,6
ENG-Premier League,2425,Southampton,Tyler Dibling,ENG,"FW,MF",19-073,2006,20.8,34,20,13,18,3,16,26,61.5,10,19,5,14,8,42,16,1
ENG-Premier League,2425,Southampton,Welington,BRA,"DF,MF",24-094,2001,4.4,20,8,14,5,1,11,17,64.7,6,4,1,3,7,27,30,0
ENG-Premier League,2425,Southampton,William Smallbone,IRL,MF,25-092,2000,7.5,19,12,8,9,2,7,21,33.3,14,8,0,8,2,21,13,2
ENG-Premier League,2425,Southampton,Yukinari Sugawara,JPN,"DF,MF",24-330,2000,16.3,29,16,14,14,1,18,30,60.0,12,17,7,10,10,39,46,3
ENG-Premier League,2425,Tottenham,Alfie Dorrington,ENG,DF,20-034,2005,0.2,0,0,0,0,0,0,0,,0,0,0,0,0,0,0,0
ENG-Premier League,2425,Tottenham,Antonín Kinský,CZE,GK,22-072,2003,6.0,3,1,3,0,0,1,1,100.0,0,0,0,0,0,3,9,1
ENG-Premier League,2425,Tottenham,Archie Gray,ENG,"DF,MF",19-073,2006,18.5,15,8,4,7,4,7,17,41.2,10,21,10,11,18,33,45,2
ENG-Premier League,2425,Tottenham,Ben Davies,WAL,DF,32-030,1993,14.5,17,11,8,8,1,9,17,52.9,8,28,19,9,12,29,77,1
ENG-Premier League,2425,Tottenham,Brandon Austin,ENG,GK,26-136,1999,1.0,0,0,0,0,0,0,0,,0,0,0,0,0,0,1,0
ENG-Premier League,2425,Tottenham,Brennan Johnson,WAL,FW,24-001,2001,23.2,39,26,9,20,10,16,31,51.6,15,25,3,22,4,43,11,0
ENG-Premier League,2425,Tottenham,Cristian Romero,ARG,DF,27-027,1998,15.7,35,29,26,8,1,21,30,70.0,9,18,3,15,21,56,57,2
ENG-Premier League,2425,Tottenham,Dane Scarlett,ENG,"FW,MF",21-061,2004,0.4,1,0,0,1,0,0,0,,0,0,0,0,0,1,1,0
ENG-Premier League,2425,Tottenham,Dejan Kulusevski,SWE,"MF,FW",25-029,2000,26.5,45,23,17,13,15,19,51,37.3,32,34,5,29,13,58,10,1
ENG-Premier League,2425,Tottenham,Destiny Udogie,ITA,DF,22-177,2002,20.4,74,47,41,26,7,33,47,70.2,14,40,6,34,21,95,35,1
ENG-Premier League,2425,Tottenham,Djed Spence,ENG,DF,24-288,2000,19.8,47,34,25,15,7,23,30,76.7,7,28,9,19,21,68,74,2
ENG-Premier League,2425,Tottenham,Dominic Solanke,ENG,FW,27-252,1997,23.7,18,11,1,12,5,4,14,28.6,10,18,7,11,0,18,22,0
ENG-Premier League,2425,Tottenham,Fraser Forster,ENG,GK,37-068,1988,7.0,0,0,0,0,0,0,1,0.0,1,0,0,0,0,0,7,3
ENG-Premier League,2425,Tottenham,Guglielmo Vicario,ITA,GK,28-229,1996,23.0,0,0,0,0,0,0,0,,0,0,0,0,1,1,14,6
ENG-Premier League,2425,Tottenham,James Maddison,ENG,MF,28-182,1996,20.1,31,19,8,16,7,9,29,31.0,20,15,4,11,12,43,19,1
ENG-Premier League,2425,Tottenham,Kevin Danso,AUT,DF,26-247,1998,8.4,7,5,4,3,0,6,11,54.5,5,12,12,0,5,12,55,1
ENG-Premier League,2425,Tottenham,Lucas Bergvall,SWE,MF,19-111,2006,13.5,39,19,14,20,5,17,32,53.1,15,18,8,10,24,63,22,3
ENG-Premier League,2425,Tottenham,Mathys Tel,FRA,FW,20-027,2005,9.2,13,5,2,6,5,2,9,22.2,7,8,1,7,2,15,5,2
ENG-Premier League,2425,Tottenham,Micky van de Ven,NED,DF,24-035,2001,10.6,10,6,5,4,1,8,14,57.1,6,9,6,3,10,20,36,1
ENG-Premier League,2425,Tottenham,Mikey Moore,ENG,FW,17-286,2007,4.1,2,1,2,0,0,0,4,0.0,4,2,0,2,1,3,5,0
ENG-Premier League,2425,Tottenham,Pape Matar Sarr,SEN,MF,22-252,2002,20.8,48,36,19,23,6,12,24,50.0,12,25,10,15,29,77,25,1
ENG-Premier League,2425,Tottenham,Pedro Porro,ESP,DF,25-253,1999,28.0,63,46,31,22,10,42,73,57.5,31,44,17,27,34,97,82,1
ENG-Premier League,2425,Tottenham,Radu Drăgușin,ROU,DF,23-110,2002,13.9,10,6,8,2,0,6,12,50.0,6,22,16,6,15,25,49,4
ENG-Premier League,2425,Tottenham,Richarlison,BRA,FW,28-014,1997,5.3,4,3,0,3,1,0,3,0.0,3,1,1,0,0,4,8,0
ENG-Premier League,2425,Tottenham,Rodrigo Bentancur,URU,MF,27-333,1997,17.6,39,21,18,17,4,19,39,48.7,20,25,8,17,36,75,35,1
ENG-Premier League,2425,Tottenham,Sergio Reguilón,ESP,DF,28-159,1996,2.2,4,3,1,3,0,2,5,40.0,3,7,0,7,4,8,8,0
ENG-Premier League,2425,Tottenham,Son Heung-min,KOR,FW,32-320,1992,23.4,17,9,3,8,6,5,27,18.5,22,11,0,11,5,22,17,1
ENG-Premier League,2425,Tottenham,Timo Werner,GER,"FW,MF",29-079,1996,5.7,6,4,3,3,0,3,13,23.1,10,10,1,9,1,7,7,0
ENG-Premier League,2425,Tottenham,Will Lankshear,ENG,"FW,MF",20-034,2005,0.1,0,0,0,0,0,0,0,,0,0,0,0,0,0,0,0
ENG-Premier League,2425,Tottenham,Wilson Odobert,FRA,"FW,MF",20-177,2004,8.9,13,4,5,3,5,8,14,57.1,6,5,0,5,4,17,5,1
ENG-Premier League,2425,Tottenham,Yves Bissouma,MLI,MF,28-267,1996,15.4,48,30,19,25,4,19,34,55.9,15,11,6,5,18,66,40,4
ENG-Premier League,2425,West Ham,Aaron Cresswell,ENG,DF,35-160,1989,9.1,11,7,5,5,1,9,11,81.8,2,9,4,5,8,19,37,0
ENG-Premier League,2425,West Ham,Aaron Wan-Bissaka,ENG,DF,27-179,1997,34.0,68,48,32,31,5,23,31,74.2,8,36,11,25,64,132,123,0
ENG-Premier League,2425,West Ham,Alphonse Areola,FRA,GK,32-086,1993,25.1,2,2,2,0,0,2,3,66.7,1,0,0,0,0,2,15,3
ENG-Premier League,2425,West Ham,Andy Irving,SCO,MF,25-011,2000,1.8,7,4,3,3,1,1,5,20.0,4,5,1,4,1,8,5,0
ENG-Premier League,2425,West Ham,Carlos Soler,ESP,"MF,FW",28-142,1997,15.6,16,11,9,6,1,7,23,30.4,16,19,6,13,8,24,21,2
ENG-Premier League,2425,West Ham,Crysencio Summerville,NED,"FW,MF",23-206,2001,8.7,13,7,2,8,3,3,9,33.3,6,13,4,9,0,13,7,0
ENG-Premier League,2425,West Ham,Danny Ings,ENG,"FW,MF",32-305,1992,3.2,4,2,2,2,0,1,3,33.3,2,5,0,5,1,5,4,0
ENG-Premier League,2425,West Ham,Edson Álvarez,MEX,MF,27-212,1997,18.8,45,24,25,12,8,15,33,45.5,18,22,8,14,17,62,41,1
ENG-Premier League,2425,West Ham,Emerson Palmieri,ITA,DF,30-294,1994,23.5,60,31,37,18,5,27,48,56.3,21,32,8,24,21,81,59,0
ENG-Premier League,2425,West Ham,Evan Ferguson,IRL,FW,20-217,2004,1.7,3,1,0,1,2,0,0,,0,2,1,1,1,4,1,0
ENG-Premier League,2425,West Ham,Guido Rodríguez,ARG,MF,31-042,1994,12.6,34,17,21,13,0,16,32,50.0,16,23,9,14,13,47,35,1
ENG-Premier League,2425,West Ham,James Ward-Prowse,ENG,MF,30-204,1994,10.7,19,14,8,7,4,7,16,43.8,9,6,3,3,7,26,15,0
ENG-Premier League,2425,West Ham,Jarrod Bowen,ENG,"FW,MF",28-155,1996,32.0,39,26,13,11,15,17,38,44.7,21,21,3,18,16,55,24,0
ENG-Premier League,2425,West Ham,Jean-Clair Todibo,FRA,DF,25-145,1999,19.3,43,26,28,14,1,25,34,73.5,9,24,12,12,24,67,79,3
ENG-Premier League,2425,West Ham,Kaelan Casey,ENG,DF,20-208,2004,0.0,0,0,0,0,0,0,0,,0,0,0,0,0,0,1,0
ENG-Premier League,2425,West Ham,Konstantinos Mavropanos,GRE,DF,27-164,1997,21.7,33,22,22,10,1,15,26,57.7,11,24,17,7,39,72,118,1
ENG-Premier League,2425,West Ham,Lewis Orford,ENG,MF,19-095,2006,0.5,0,0,0,0,0,0,0,,0,1,0,1,1,1,0,0
ENG-Premier League,2425,West Ham,Lucas Paquetá,BRA,"MF,FW",27-270,1997,26.3,66,37,25,30,11,27,54,50.0,27,29,4,25,18,84,37,6
ENG-Premier League,2425,West Ham,Luis Guilherme,BRA,"MF,FW",19-104,2006,1.7,1,0,1,0,0,0,3,0.0,3,7,0,7,3,4,2,0
ENG-Premier League,2425,West Ham,Max Kilman,ENG,DF,28-001,1997,36.2,38,24,16,19,3,23,27,85.2,4,57,39,18,38,76,207,5
ENG-Premier League,2425,West Ham,Michail Antonio,JAM,FW,35-057,1990,9.3,2,2,0,1,1,2,3,66.7,1,6,0,6,0,2,2,0
ENG-Premier League,2425,West Ham,Mohammed Kudus,GHA,"FW,MF",24-295,2000,28.6,37,22,8,18,11,10,27,37.0,17,24,1,23,4,41,8,2
ENG-Premier League,2425,West Ham,Niclas Füllkrug,GER,FW,32-104,1993,8.0,4,3,0,1,3,3,4,75.0,1,1,0,1,1,5,13,0
ENG-Premier League,2425,West Ham,Oliver Scarles,ENG,DF,19-163,2005,6.6,17,11,13,3,1,13,21,61.9,8,14,2,12,10,27,24,0
ENG-Premier League,2425,West Ham,Tomáš Souček,CZE,MF,30-086,1995,27.5,45,21,20,22,3,25,42,59.5,17,38,20,18,19,64,82,1
ENG-Premier League,2425,West Ham,Vladimír Coufal,CZE,DF,32-275,1992,11.6,22,15,13,7,2,10,22,45.5,12,13,11,2,8,30,38,1
ENG-Premier League,2425,West Ham,Łukasz Fabiański,POL,GK,40-036,1985,11.9,0,0,0,0,0,0,1,0.0,1,0,0,0,0,0,5,1
ENG-Premier League,2425,Wolves,Alfie Pond,ENG,DF,21-084,2004,0.0,0,0,0,0,0,0,0,,0,0,0,0,0,0,0,0
ENG-Premier League,2425,Wolves,André,BRA,MF,23-312,2001,26.5,89,54,40,41,8,36,62,58.1,26,42,8,34,37,126,30,1
ENG-Premier League,2425,Wolves,Boubacar Traoré,MLI,MF,23-277,2001,0.0,2,0,0,2,0,1,1,100.0,0,0,0,0,0,2,0,0
ENG-Premier League,2425,Wolves,Carlos Forbs,POR,"MF,FW",21-066,2004,2.7,8,5,5,2,1,4,6,66.7,2,3,0,3,1,9,2,1
ENG-Premier League,2425,Wolves,Chiquinho,POR,MF,25-108,2000,0.1,0,0,0,0,0,0,0,,0,0,0,0,0,0,0,0
ENG-Premier League,2425,Wolves,Craig Dawson,ENG,DF,35-018,1990,10.8,15,3,8,6,1,12,15,80.0,3,16,11,5,9,24,52,1
ENG-Premier League,2425,Wolves,Daniel Bentley,ENG,GK,31-315,1993,2.0,0,0,0,0,0,0,0,,0,0,0,0,0,0,1,0
ENG-Premier League,2425,Wolves,Daniel Podence,POR,"MF,FW",29-215,1995,0.5,0,0,0,0,0,0,1,0.0,1,0,0,0,0,0,0,0
ENG-Premier League,2425,Wolves,Emmanuel Agbadou,CIV,DF,27-341,1997,14.7,28,18,19,9,0,12,19,63.2,7,19,13,6,11,39,85,0
ENG-Premier League,2425,Wolves,Gonçalo Guedes,POR,"MF,FW",28-176,1996,10.3,15,5,2,5,8,4,16,25.0,12,11,0,11,5,20,4,0
ENG-Premier League,2425,Wolves,Hwang Hee-chan,KOR,"MF,FW",29-118,1996,7.3,6,4,2,1,3,2,6,33.3,4,9,0,9,2,8,11,0
ENG-Premier League,2425,Wolves,Jean-Ricner Bellegarde,FRA,"MF,FW",26-331,1998,18.6,39,24,17,19,3,14,20,70.0,6,19,3,16,10,49,18,1
ENG-Premier League,2425,Wolves,José Sá,POR,GK,32-127,1993,28.0,2,2,2,0,0,2,2,100.0,0,0,0,0,0,2,15,1
ENG-Premier League,2425,Wolves,João Gomes,BRA,MF,24-101,2001,32.0,108,64,53,50,5,44,105,41.9,61,42,4,38,25,133,32,0
ENG-Premier League,2425,Wolves,Jørgen Strand Larsen,NOR,FW,25-107,2000,28.5,10,6,2,3,5,4,27,14.8,23,19,4,15,6,16,28,0
ENG-Premier League,2425,Wolves,Mario Lemina,GAB,"MF,DF",31-265,1993,15.2,51,31,27,19,5,20,29,69.0,9,12,7,5,27,78,50,3
ENG-Premier League,2425,Wolves,Marshall Munetsi,ZIM,"MF,FW",28-336,1996,11.0,22,10,6,10,6,12,21,57.1,9,13,1,12,6,28,17,0
ENG-Premier League,2425,Wolves,Mateus Mane,,MF,,,0.0,0,0,0,0,0,0,0,,0,1,0,1,0,0,0,0
ENG-Premier League,2425,Wolves,Matheus Cunha,BRA,"MF,FW",25-362,1999,27.9,36,21,17,15,4,12,37,32.4,25,21,1,20,17,53,23,0
ENG-Premier League,2425,Wolves,Matt Doherty,IRL,DF,33-128,1992,22.5,37,20,25,12,0,16,24,66.7,8,27,15,12,22,59,95,3
ENG-Premier League,2425,Wolves,Nasser Djiga,BFA,DF,22-190,2002,0.7,0,0,0,0,0,0,1,0.0,1,0,0,0,2,2,4,1
ENG-Premier League,2425,Wolves,Nélson Semedo,POR,DF,31-189,1993,31.1,60,34,31,21,8,32,55,58.2,23,31,10,21,23,83,101,3
ENG-Premier League,2425,Wolves,Pablo Sarabia,ESP,"MF,FW",33-013,1992,9.0,16,8,4,8,4,10,16,62.5,6,10,0,10,4,20,7,1
ENG-Premier League,2425,Wolves,Pedro Lima,BRA,DF,18-327,2006,0.8,1,0,0,0,1,1,3,33.3,2,0,0,0,2,3,5,0
ENG-Premier League,2425,Wolves,Rayan Aït-Nouri,ALG,DF,23-352,2001,33.8,86,55,51,27,8,41,68,60.3,27,42,6,36,25,111,72,1
ENG-Premier League,2425,Wolves,Rodrigo Gomes,POR,"DF,FW",21-321,2003,8.7,23,15,14,9,0,12,21,57.1,9,8,1,7,5,28,20,1
ENG-Premier League,2425,Wolves,Sam Johnstone,ENG,GK,32-060,1993,7.0,0,0,0,0,0,0,1,0.0,1,0,0,0,0,0,7,0
ENG-Premier League,2425,Wolves,Santiago Bueno,URU,DF,26-196,1998,18.7,40,21,21,18,1,17,22,77.3,5,35,20,15,15,55,70,0
ENG-Premier League,2425,Wolves,Tommy Doyle,ENG,MF,23-219,2001,5.4,11,6,6,3,2,6,15,40.0,9,11,5,6,5,16,11,1
ENG-Premier League,2425,Wolves,Toti Gomes,POR,DF,26-128,1999,28.0,60,42,42,14,4,36,45,80.0,9,29,17,12,24,84,149,5
ENG-Premier League,2425,Wolves,Yerson Mosquera,COL,DF,24-022,2001,4.9,11,7,9,2,0,9,14,64.3,5,13,10,3,10,21,14,0
ESP-La Liga,2425,Alavés,Abdel Abqar,MAR,DF,26-075,1999,27.4,36,23,24,11,1,20,34,58.8,14,28,18,10,39,75,146,1
ESP-La Liga,2425,Alavés,Abderrahman Rebbach,ALG,"FW,MF",26-286,1998,4.3,3,2,3,0,0,0,6,0.0,6,4,0,4,0,3,6,0
ESP-La Liga,2425,Alavés,Adrian Rodriguez,ESP,GK,24-163,2000,1.4,0,0,0,0,0,0,1,0.0,1,0,0,0,0,0,3,1
ESP-La Liga,2425,Alavés,Aleksandar Sedlar,SRB,DF,33-162,1991,5.7,17,9,7,10,0,8,10,80.0,2,2,1,1,9,26,18,1
ESP-La Liga,2425,Alavés,Ander Guevara,ESP,MF,27-321,1997,21.6,49,30,19,29,1,20,48,41.7,28,21,5,16,14,63,43,1
ESP-La Liga,2425,Alavés,Antonio Blanco,ESP,MF,24-305,2000,29.3,65,40,22,37,6,32,81,39.5,49,28,6,22,40,105,47,1
ESP-La Liga,2425,Alavés,Antonio Sivera,ESP,GK,28-286,1996,30.2,2,1,2,0,0,2,2,100.0,0,1,0,1,0,2,19,0
ESP-La Liga,2425,Alavés,Asier Villalibre,ESP,FW,27-236,1997,3.7,2,2,0,1,1,1,2,50.0,1,1,0,1,1,3,7,0
ESP-La Liga,2425,Alavés,Carles Aleñá,ESP,"MF,FW",27-139,1998,11.1,18,11,6,6,6,7,17,41.2,10,11,0,11,2,20,4,0
ESP-La Liga,2425,Alavés,Carlos Benavídez,URU,MF,27-055,1998,4.5,13,10,6,5,2,5,9,55.6,4,4,2,2,8,21,12,1
ESP-La Liga,2425,Alavés,Carlos Martín,ESP,"FW,MF",23-032,2002,14.7,41,20,16,16,9,13,49,26.5,36,30,1,29,5,46,18,0
ESP-La Liga,2425,Alavés,Carlos Vicente,ESP,"FW,MF",26-031,1999,33.4,43,28,23,11,9,23,60,38.3,37,31,2,29,14,57,40,0
ESP-La Liga,2425,Alavés,Facundo Garcés,ARG,DF,25-261,1999,6.5,5,1,3,2,0,3,5,60.0,2,8,6,2,4,9,43,0
ESP-La Liga,2425,Alavés,Hugo Novoa,ESP,"DF,MF",22-143,2003,2.6,8,5,4,3,1,5,5,100.0,0,2,1,1,0,8,6,0
ESP-La Liga,2425,Alavés,Jesús Owono,EQG,GK,24-084,2001,5.4,1,1,1,0,0,1,1,100.0,0,0,0,0,0,1,2,0
ESP-La Liga,2425,Alavés,Joan Jordán,ESP,MF,30-322,1994,15.7,32,18,11,17,4,17,30,56.7,13,12,0,12,9,41,21,0
ESP-La Liga,2425,Alavés,Jon Guridi,ESP,"MF,FW",30-085,1995,22.4,40,22,7,26,7,18,44,40.9,26,19,1,18,14,54,16,0
ESP-La Liga,2425,Alavés,Kiké,ESP,FW,35-180,1989,27.6,19,14,1,12,6,6,15,40.0,9,9,2,7,1,20,23,0
ESP-La Liga,2425,Alavés,Luis Rioja,ESP,FW,31-220,1993,0.3,2,1,0,1,1,1,2,50.0,1,2,0,2,0,2,0,0
ESP-La Liga,2425,Alavés,Luka Romero,ARG,"FW,MF",20-187,2004,2.2,4,4,1,1,2,2,3,66.7,1,2,0,2,1,5,0,0
ESP-La Liga,2425,Alavés,Manu Sánchez,ESP,DF,24-273,2000,28.3,78,52,38,30,10,41,69,59.4,28,49,11,38,30,108,73,1
ESP-La Liga,2425,Alavés,Moussa Diarra,MLI,DF,24-195,2000,20.7,40,24,19,18,3,17,29,58.6,12,15,5,10,21,61,46,1
ESP-La Liga,2425,Alavés,Nahuel Tenaglia,ARG,DF,29-092,1996,31.5,93,58,58,30,5,51,82,62.2,31,33,9,24,42,135,121,2
ESP-La Liga,2425,Alavés,Pau Cabanes,ESP,"MF,FW",20-096,2005,2.1,8,2,4,3,1,6,13,46.2,7,2,0,2,0,8,1,0
ESP-La Liga,2425,Alavés,Pica,ESP,DF,23-143,2002,5.4,9,7,7,2,0,4,9,44.4,5,7,6,1,8,17,23,0
ESP-La Liga,2425,Alavés,Santiago Mouriño,URU,DF,23-100,2002,20.5,43,28,31,12,0,21,38,55.3,17,27,12,15,29,72,120,0
ESP-La Liga,2425,Alavés,Stoichkov,ESP,"MF,FW",31-200,1993,7.8,14,9,6,7,1,6,11,54.5,5,2,0,2,1,15,7,0
ESP-La Liga,2425,Alavés,Tomás Conechny,ARG,"FW,MF",27-055,1998,9.1,13,10,5,6,2,9,26,34.6,17,13,2,11,6,19,9,0
ESP-La Liga,2425,Alavés,Toni Martínez,ESP,"FW,MF",27-328,1997,10.9,12,7,5,4,3,4,7,57.1,3,8,2,6,1,13,14,0
ESP-La Liga,2425,Athletic Club,Adama Boiro,ESP,"DF,FW",22-336,2002,12.2,20,11,11,7,2,10,15,66.7,5,10,3,7,12,32,27,1
ESP-La Liga,2425,Athletic Club,Adu Ares,ESP,FW,23-224,2001,0.2,0,0,0,0,0,0,1,0.0,1,0,0,0,0,0,0,0
ESP-La Liga,2425,Athletic Club,Aingeru Olabarrieta,ESP,FW,19-191,2005,0.6,0,0,0,0,0,0,0,,0,2,0,2,1,1,1,0
ESP-La Liga,2425,Athletic Club,Aitor Paredes,ESP,DF,25-025,2000,19.1,14,12,9,5,0,7,14,50.0,7,24,14,10,22,36,109,4
ESP-La Liga,2425,Athletic Club,Alex Padilla,ESP,GK,21-265,2003,3.6,0,0,0,0,0,0,0,,0,0,0,0,0,0,2,1
ESP-La Liga,2425,Athletic Club,Ander Herrera,ESP,MF,35-283,1989,3.0,8,4,1,7,0,3,6,50.0,3,1,0,1,2,10,10,0
ESP-La Liga,2425,Athletic Club,Andoni Gorosabel,ESP,DF,28-293,1996,16.5,47,28,31,9,7,30,45,66.7,15,18,2,16,18,65,62,0
ESP-La Liga,2425,Athletic Club,Beñat Prados,ESP,MF,24-105,2001,18.7,52,34,20,24,8,23,51,45.1,28,21,2,19,28,80,26,0
ESP-La Liga,2425,Athletic Club,Daniel Vivian,ESP,DF,25-313,1999,28.7,40,26,23,14,3,21,32,65.6,11,26,10,16,47,87,152,2
ESP-La Liga,2425,Athletic Club,Endika Buján,ESP,FW,22-128,2003,0.1,0,0,0,0,0,0,1,0.0,1,0,0,0,0,0,0,0
ESP-La Liga,2425,Athletic Club,Gorka Guruzeta,ESP,FW,28-254,1996,20.4,16,8,1,13,2,7,31,22.6,24,28,4,24,9,25,23,0
ESP-La Liga,2425,Athletic Club,Iñaki Williams,GHA,FW,30-343,1994,29.3,17,10,4,8,5,12,23,52.2,11,34,5,29,12,29,32,0
ESP-La Liga,2425,Athletic Club,Iñigo Lekue,ESP,DF,32-020,1993,8.6,15,12,12,3,0,9,17,52.9,8,7,2,5,9,24,29,2
ESP-La Liga,2425,Athletic Club,Iñigo Ruiz de Galarreta,ESP,MF,31-291,1993,15.7,35,21,11,17,7,20,31,64.5,11,10,3,7,15,50,13,2
ESP-La Liga,2425,Athletic Club,Javi Martón,ESP,"FW,MF",26-018,1999,0.6,0,0,0,0,0,0,0,,0,0,0,0,0,0,0,0
ESP-La Liga,2425,Athletic Club,Julen Agirrezabala,ESP,GK,24-149,2000,13.4,0,0,0,0,0,0,1,0.0,1,0,0,0,0,0,4,0
ESP-La Liga,2425,Athletic Club,Maroan Sannadi,ESP,FW,24-112,2001,7.4,5,0,1,4,0,2,7,28.6,5,1,0,1,0,5,1,1
ESP-La Liga,2425,Athletic Club,Mikel Jauregizar,ESP,MF,21-193,2003,23.9,82,47,24,44,14,41,78,52.6,37,24,4,20,27,109,36,2
ESP-La Liga,2425,Athletic Club,Mikel Vesga,ESP,MF,32-003,1993,11.0,22,15,7,13,2,12,28,42.9,16,10,1,9,15,37,26,0
ESP-La Liga,2425,Athletic Club,Nico Williams,ESP,FW,22-316,2002,21.3,27,17,10,11,6,10,31,32.3,21,19,1,18,6,33,9,0
ESP-La Liga,2425,Athletic Club,Nicolás Serrano,ESP,FW,22-080,2003,1.2,1,1,0,1,0,1,3,33.3,2,4,0,4,1,2,1,0
ESP-La Liga,2425,Athletic Club,Oihan Sancet,ESP,MF,25-029,2000,17.7,13,8,6,6,1,5,14,35.7,9,9,0,9,5,18,6,0
ESP-La Liga,2425,Athletic Club,Peio Canales,ESP,"MF,FW",20-127,2005,2.9,3,2,0,1,2,1,1,100.0,0,3,0,3,2,5,2,0
ESP-La Liga,2425,Athletic Club,Unai Gómez,ESP,"MF,FW",21-364,2003,13.6,12,8,3,7,2,4,7,57.1,3,13,1,12,2,14,14,0
ESP-La Liga,2425,Athletic Club,Unai Núñez,ESP,DF,28-114,1997,6.5,9,4,6,3,0,3,6,50.0,3,4,4,0,17,26,43,1
ESP-La Liga,2425,Athletic Club,Unai Simón,ESP,GK,27-347,1997,20.0,0,0,0,0,0,0,0,,0,1,0,1,1,1,13,4
ESP-La Liga,2425,Athletic Club,Yeray Álvarez,ESP,DF,30-120,1995,19.8,25,13,14,9,2,15,22,68.2,7,10,6,4,34,59,129,1
ESP-La Liga,2425,Athletic Club,Yuri Berchiche,ESP,DF,35-103,1990,21.7,33,21,19,11,3,19,30,63.3,11,22,4,18,25,58,69,2
ESP-La Liga,2425,Athletic Club,Álex Berenguer,ESP,"FW,MF",29-324,1995,25.0,30,14,5,16,9,13,28,46.4,15,21,2,19,10,40,18,0
ESP-La Liga,2425,Athletic Club,Álvaro djaló,ESP,FW,25-281,1999,7.3,8,5,3,2,3,1,3,33.3,2,4,0,4,1,9,4,0
ESP-La Liga,2425,Athletic Club,Óscar de Marcos,ESP,DF,36-040,1989,16.4,32,15,15,13,4,21,37,56.8,16,17,1,16,15,47,32,0
ESP-La Liga,2425,Atlético Madrid,Adrian Niño,ESP,FW,20-339,2004,0.1,0,0,0,0,0,0,0,,0,0,0,0,0,0,0,0
ESP-La Liga,2425,Atlético Madrid,Alexander Sørloth,NOR,FW,29-170,1995,17.1,9,5,2,5,2,3,5,60.0,2,6,1,5,1,10,28,0
ESP-La Liga,2425,Atlético Madrid,Antoine Griezmann,FRA,"FW,MF",34-064,1991,26.8,30,17,13,13,4,7,29,24.1,22,16,1,15,6,36,23,1
ESP-La Liga,2425,Atlético Madrid,Axel Witsel,BEL,DF,36-132,1989,8.5,13,12,4,8,1,10,12,83.3,2,15,8,7,9,22,33,1
ESP-La Liga,2425,Atlético Madrid,Clément Lenglet,FRA,DF,29-341,1995,20.9,25,16,17,8,0,10,14,71.4,4,24,18,6,21,46,98,1
ESP-La Liga,2425,Atlético Madrid,Conor Gallagher,ENG,MF,25-107,2000,17.9,44,31,16,18,10,22,49,44.9,27,23,5,18,20,64,23,0
ESP-La Liga,2425,Atlético Madrid,César Azpilicueta,ESP,DF,35-269,1989,8.7,24,13,12,8,4,17,23,73.9,6,8,2,6,4,28,28,0
ESP-La Liga,2425,Atlético Madrid,Giuliano Simeone,ARG,MF,22-157,2002,21.1,25,13,6,9,10,14,29,48.3,15,22,3,19,14,39,22,1
ESP-La Liga,2425,Atlético Madrid,Jan Oblak,SVN,GK,32-137,1993,36.0,0,0,0,0,0,0,0,,0,0,0,0,0,0,17,2
ESP-La Liga,2425,Atlético Madrid,Javi Galán,ESP,DF,30-186,1994,19.8,51,31,31,15,5,25,49,51.0,24,13,3,10,12,63,47,0
ESP-La Liga,2425,Atlético Madrid,José María Giménez,URU,DF,30-124,1995,22.2,26,16,18,8,0,17,28,60.7,11,29,19,10,27,53,115,2
ESP-La Liga,2425,Atlético Madrid,Juan Musso,ARG,GK,31-018,1994,1.0,0,0,0,0,0,0,0,,0,0,0,0,0,0,0,0
ESP-La Liga,2425,Atlético Madrid,Julián Álvarez,ARG,FW,25-113,2000,26.9,24,16,5,10,9,8,29,27.6,21,14,0,14,2,26,11,1
ESP-La Liga,2425,Atlético Madrid,Koke,ESP,MF,33-136,1992,20.6,44,22,17,21,6,21,43,48.8,22,23,2,21,20,64,28,2
ESP-La Liga,2425,Atlético Madrid,Marcos Llorente,ESP,"DF,MF",30-114,1995,26.9,67,50,37,26,4,35,53,66.0,18,31,7,24,26,93,50,1
ESP-La Liga,2425,Atlético Madrid,Nahuel Molina,ARG,DF,27-048,1998,17.0,42,19,20,21,1,30,55,54.5,25,16,3,13,12,54,51,0
ESP-La Liga,2425,Atlético Madrid,Pablo Barrios,ESP,MF,21-343,2003,25.7,45,26,22,20,3,23,47,48.9,24,18,5,13,34,79,33,9
ESP-La Liga,2425,Atlético Madrid,Reinildo Mandava,MOZ,DF,31-123,1994,10.5,18,11,10,7,1,10,18,55.6,8,11,5,6,16,34,35,0
ESP-La Liga,2425,Atlético Madrid,Robin Le Normand,ESP,DF,28-194,1996,23.9,27,18,23,4,0,12,20,60.0,8,20,9,11,10,37,120,1
ESP-La Liga,2425,Atlético Madrid,Rodrigo De Paul,ARG,MF,31-000,1994,22.5,33,26,12,16,5,14,33,42.4,19,23,2,21,6,39,15,3
ESP-La Liga,2425,Atlético Madrid,Rodrigo Riquelme,ESP,"MF,DF",25-052,2000,5.7,11,5,4,6,1,6,11,54.5,5,3,0,3,2,13,3,0
ESP-La Liga,2425,Atlético Madrid,Samuel Lino,BRA,"MF,DF",25-152,1999,16.5,31,16,23,4,4,20,47,42.6,27,23,4,19,7,38,12,0
ESP-La Liga,2425,Atlético Madrid,Thomas Lemar,FRA,MF,29-193,1995,0.9,2,1,1,1,0,2,4,50.0,2,0,0,0,0,2,1,0
ESP-La Liga,2425,Atlético Madrid,Ángel Correa,ARG,"FW,MF",30-076,1995,8.7,8,2,4,1,3,4,14,28.6,10,9,0,9,4,12,7,0
ESP-La Liga,2425,Barcelona,Alejandro Balde,ESP,DF,21-218,2003,24.5,18,10,10,5,3,11,16,68.8,5,24,5,19,5,23,27,0
ESP-La Liga,2425,Barcelona,Andreas Christensen,DEN,DF,29-044,1996,2.5,6,4,4,1,1,4,4,100.0,0,1,0,1,4,10,8,0
ESP-La Liga,2425,Barcelona,Ansu Fati,ESP,FW,22-205,2002,2.6,4,1,0,2,2,1,2,50.0,1,1,0,1,1,5,0,1
ESP-La Liga,2425,Barcelona,Dani Olmo,ESP,"MF,FW",27-017,1998,13.2,16,11,8,5,3,4,14,28.6,10,6,3,3,3,19,10,1
ESP-La Liga,2425,Barcelona,Daniel Rodriguez,ESP,FW,19-288,2005,0.4,0,0,0,0,0,0,0,,0,1,0,1,0,0,0,0
ESP-La Liga,2425,Barcelona,Eric García,ESP,"DF,MF",24-135,2001,16.4,33,19,7,23,3,16,24,66.7,8,24,8,16,14,47,39,0
ESP-La Liga,2425,Barcelona,Fermin López,ESP,"MF,FW",22-013,2003,12.9,18,14,3,8,7,7,25,28.0,18,11,0,11,5,23,3,0
ESP-La Liga,2425,Barcelona,Ferrán Torres,ESP,"FW,MF",25-084,2000,12.3,8,4,2,3,3,3,8,37.5,5,7,1,6,4,12,5,0
ESP-La Liga,2425,Barcelona,Frenkie de Jong,NED,MF,28-012,1997,12.6,19,11,5,8,6,8,16,50.0,8,9,1,8,12,31,6,1
ESP-La Liga,2425,Barcelona,Gavi,ESP,"MF,FW",20-292,2004,11.1,22,18,4,13,5,12,21,57.1,9,13,1,12,10,32,6,0
ESP-La Liga,2425,Barcelona,Gerard Martín,ESP,DF,23-143,2002,11.4,22,10,10,7,5,11,16,68.8,5,16,2,14,12,34,27,0
ESP-La Liga,2425,Barcelona,Héctor Fort,ESP,DF,18-295,2006,6.5,13,8,6,4,3,10,16,62.5,6,12,0,12,6,19,16,0
ESP-La Liga,2425,Barcelona,Iñaki Peña,ESP,GK,26-083,1999,14.5,0,0,0,0,0,0,2,0.0,2,0,0,0,0,0,20,1
ESP-La Liga,2425,Barcelona,Iñigo Martínez,ESP,DF,34-007,1991,27.7,25,14,20,5,0,16,22,72.7,6,18,7,11,18,43,108,1
ESP-La Liga,2425,Barcelona,Jules Koundé,FRA,DF,26-193,1998,28.9,63,43,29,23,11,44,66,66.7,22,35,5,30,20,83,68,2
ESP-La Liga,2425,Barcelona,Lamine Yamal,ESP,FW,17-315,2007,30.7,42,28,8,17,17,16,36,44.4,20,12,0,12,15,57,3,0
ESP-La Liga,2425,Barcelona,Marc Bernal,ESP,MF,17-363,2007,2.7,8,6,2,5,1,7,8,87.5,1,5,1,4,1,9,4,0
ESP-La Liga,2425,Barcelona,Marc Casado,ESP,MF,21-252,2003,17.9,44,25,7,30,7,20,41,48.8,21,20,5,15,22,66,22,1
ESP-La Liga,2425,Barcelona,Marc-André ter Stegen,GER,GK,33-024,1992,7.5,0,0,0,0,0,0,1,0.0,1,0,0,0,0,0,2,2
ESP-La Liga,2425,Barcelona,Pablo Torre,ESP,"MF,FW",22-051,2003,3.4,5,4,1,3,1,2,4,50.0,2,0,0,0,3,8,5,1
ESP-La Liga,2425,Barcelona,Pau Cubarsí,ESP,DF,18-122,2007,28.1,33,23,21,9,3,19,30,63.3,11,12,9,3,15,48,82,1
ESP-La Liga,2425,Barcelona,Pau Victor Delgado,ESP,FW,23-179,2001,3.5,3,1,0,2,1,0,3,0.0,3,6,1,5,2,5,5,0
ESP-La Liga,2425,Barcelona,Pedri,ESP,MF,22-180,2002,31.1,59,32,14,36,9,23,68,33.8,45,45,3,42,26,85,21,1
ESP-La Liga,2425,Barcelona,Raphinha,BRA,"FW,MF",28-161,1996,30.8,36,22,6,19,11,19,38,50.0,19,29,2,27,10,46,25,0
ESP-La Liga,2425,Barcelona,Robert Lewandowski,POL,FW,36-276,1988,28.7,10,5,1,5,4,5,11,45.5,6,14,2,12,3,13,26,0
ESP-La Liga,2425,Barcelona,Ronald Araújo,URU,DF,26-078,1999,7.7,12,9,6,5,1,4,4,100.0,0,6,4,2,9,21,21,0
ESP-La Liga,2425,Barcelona,Sergi Dominguez,ESP,DF,20-053,2005,1.9,1,1,1,0,0,0,0,,0,0,0,0,3,4,7,0
ESP-La Liga,2425,Barcelona,Wojciech Szczęsny,POL,GK,35-036,1990,15.0,1,1,1,0,0,0,0,,0,0,0,0,0,1,20,1
ESP-La Liga,2425,Betis,Abde Ezzalzouli,MAR,"FW,MF",23-158,2001,22.0,37,25,17,16,4,15,27,55.6,12,22,3,19,7,44,19,0
ESP-La Liga,2425,Betis,Adrián,ESP,GK,38-141,1987,19.0,0,0,0,0,0,0,3,0.0,3,0,0,0,0,0,14,3
ESP-La Liga,2425,Betis,Aitor Ruibal,ESP,"DF,FW",29-063,1996,14.6,33,23,22,5,6,26,47,55.3,21,20,5,15,14,47,40,1
ESP-La Liga,2425,Betis,Antony,BRA,FW,25-089,2000,15.1,25,11,6,9,10,8,23,34.8,15,12,1,11,9,34,9,1
ESP-La Liga,2425,Betis,Assane Diao,SEN,FW,19-259,2005,3.1,5,3,1,3,1,4,9,44.4,5,3,0,3,0,5,3,0
ESP-La Liga,2425,Betis,Carlos Guirao,ESP,MF,22-027,2003,1.2,5,3,1,4,0,4,6,66.7,2,1,1,0,3,8,2,0
ESP-La Liga,2425,Betis,Cucho,COL,FW,26-034,1999,12.7,15,10,2,5,8,6,11,54.5,5,13,1,12,7,22,4,0
ESP-La Liga,2425,Betis,Cédric Bakambu,COD,FW,34-043,1991,7.9,6,4,0,5,1,3,7,42.9,4,13,2,11,0,6,5,0
ESP-La Liga,2425,Betis,Diego Llorente,ESP,DF,31-281,1993,28.0,36,20,23,12,1,25,38,65.8,13,29,20,9,43,79,154,1
ESP-La Liga,2425,Betis,Ezequiel Ávila,ARG,FW,31-107,1994,7.5,8,3,2,2,4,4,10,40.0,6,4,0,4,2,10,8,0
ESP-La Liga,2425,Betis,Fran Vieites,ESP,GK,26-017,1999,4.0,0,0,0,0,0,0,0,,0,0,0,0,0,0,1,0
ESP-La Liga,2425,Betis,Giovani Lo Celso,ARG,"MF,FW",29-045,1996,16.2,34,22,8,17,9,17,25,68.0,8,14,2,12,5,39,3,1
ESP-La Liga,2425,Betis,Héctor Bellerín,ESP,DF,30-066,1995,6.4,13,7,7,4,2,10,17,58.8,7,5,3,2,6,19,21,0
ESP-La Liga,2425,Betis,Iker Losada,ESP,"MF,FW",23-296,2001,3.7,10,7,2,4,4,5,10,50.0,5,2,0,2,3,13,2,0
ESP-La Liga,2425,Betis,Isco,ESP,MF,33-033,1992,17.2,20,13,3,13,4,7,28,25.0,21,10,0,10,11,31,7,0
ESP-La Liga,2425,Betis,Jesus Rodríguez,ESP,FW,19-184,2005,12.3,17,14,6,7,4,5,18,27.8,13,16,0,16,6,23,3,0
ESP-La Liga,2425,Betis,Johnny Cardoso,USA,MF,23-246,2001,23.8,55,31,12,35,8,20,52,38.5,32,27,12,15,48,103,64,1
ESP-La Liga,2425,Betis,Juanmi,ESP,"FW,MF",32-004,1993,2.7,7,4,3,3,1,4,6,66.7,2,4,0,4,1,8,4,0
ESP-La Liga,2425,Betis,Marc Bartra,ESP,DF,34-129,1991,23.3,34,19,20,14,0,14,25,56.0,11,41,25,16,32,66,148,0
ESP-La Liga,2425,Betis,Marc Roca,ESP,MF,28-179,1996,10.1,20,14,10,9,1,9,17,52.9,8,17,5,12,14,34,14,2
ESP-La Liga,2425,Betis,Mateo Flores,ESP,MF,21-047,2004,1.7,3,1,3,0,0,1,1,100.0,0,1,0,1,2,5,3,0
ESP-La Liga,2425,Betis,Nabil Fekir,FRA,MF,31-310,1993,2.0,3,2,1,1,1,1,2,50.0,1,2,0,2,0,3,0,0
ESP-La Liga,2425,Betis,Natan,BRA,DF,24-107,2001,24.2,35,24,24,9,2,26,30,86.7,4,24,14,10,28,63,123,2
ESP-La Liga,2425,Betis,Nobel Mendy,FRA,DF,20-263,2004,1.2,0,0,0,0,0,0,0,,0,2,0,2,4,4,10,1
ESP-La Liga,2425,Betis,Pablo Fornals,ESP,"MF,FW",29-091,1996,20.3,21,13,12,6,3,10,30,33.3,20,24,4,20,24,45,15,1
ESP-La Liga,2425,Betis,Pablo Garcia,ESP,FW,18-282,2006,0.4,0,0,0,0,0,0,0,,0,1,0,1,0,0,0,0
ESP-La Liga,2425,Betis,Ricardo Rodríguez,SUI,DF,32-272,1992,14.2,28,15,16,5,7,17,26,65.4,9,10,1,9,8,36,51,0
ESP-La Liga,2425,Betis,Rodri,ESP,FW,25-008,2000,1.3,2,1,1,1,0,1,2,50.0,1,2,1,1,1,3,1,1
ESP-La Liga,2425,Betis,Romain Perraud,FRA,DF,27-244,1997,22.2,36,22,15,16,5,21,46,45.7,25,18,4,14,22,58,71,1
ESP-La Liga,2425,Betis,Rui Silva,POR,GK,31-106,1994,15.0,0,0,0,0,0,0,1,0.0,1,1,0,1,0,0,7,0
ESP-La Liga,2425,Betis,Sergi Altimira,ESP,MF,23-272,2001,21.9,61,37,17,38,6,36,60,60.0,24,28,1,27,23,84,43,3
ESP-La Liga,2425,Betis,Sergio Arribas,ESP,DF,22-103,2003,1.0,7,4,4,3,0,6,7,85.7,1,2,2,0,3,10,4,0
ESP-La Liga,2425,Betis,Vitor Roque,BRA,FW,20-085,2005,13.7,11,6,1,6,4,1,5,20.0,4,5,0,5,7,18,4,0
ESP-La Liga,2425,Betis,William Carvalho,POR,MF,33-047,1992,5.4,9,6,3,6,0,4,6,66.7,2,6,2,4,3,12,6,0
ESP-La Liga,2425,Betis,Youssouf Sabaly,SEN,DF,32-080,1993,17.6,40,25,21,15,4,24,32,75.0,8,21,4,17,13,53,40,0
ESP-La Liga,2425,Betis,Ángel Ortíz,ESP,DF,20-303,2004,3.9,12,8,8,3,1,8,17,47.1,9,6,0,6,5,17,7,0
ESP-La Liga,2425,Celta Vigo,Alfon,ESP,"FW,MF",26-020,1999,14.4,7,3,3,2,2,3,11,27.3,8,7,0,7,4,11,5,1
ESP-La Liga,2425,Celta Vigo,Anastasios Douvikas,GRE,FW,25-295,1999,7.8,9,4,2,6,1,3,6,50.0,3,5,2,3,3,12,6,0
ESP-La Liga,2425,Celta Vigo,Borja Iglesias,ESP,FW,32-127,1993,20.9,10,9,2,5,3,4,14,28.6,10,8,2,6,6,16,9,0
ESP-La Liga,2425,Celta Vigo,Carl Starfelt,SWE,DF,29-357,1995,25.2,40,20,25,14,1,18,27,66.7,9,29,21,8,31,71,129,3
ESP-La Liga,2425,Celta Vigo,Carlos Dominguez,ESP,DF,24-102,2001,12.1,23,11,14,9,0,15,21,71.4,6,13,8,5,9,32,74,1
ESP-La Liga,2425,Celta Vigo,Damián Rodríguez,ESP,MF,22-068,2003,10.3,14,9,3,10,1,6,16,37.5,10,6,1,5,7,21,13,0
ESP-La Liga,2425,Celta Vigo,Fer López,,"FW,MF",,,7.4,9,5,1,6,2,2,13,15.4,11,9,0,9,2,11,7,0
ESP-La Liga,2425,Celta Vigo,Fran Beltrán,ESP,MF,26-110,1999,25.9,47,34,23,19,5,21,52,40.4,31,25,6,19,26,73,34,4
ESP-La Liga,2425,Celta Vigo,Franco Cervi,ARG,"FW,MF",30-363,1994,3.0,8,3,2,6,0,3,8,37.5,5,4,0,4,8,16,7,0
ESP-La Liga,2425,Celta Vigo,Hugo Sotelo,ESP,MF,21-156,2003,13.9,28,17,8,10,10,13,30,43.3,17,9,1,8,5,33,9,1
ESP-La Liga,2425,Celta Vigo,Hugo Álvarez,ESP,"MF,DF",21-326,2003,17.5,26,9,12,10,4,10,19,52.6,9,19,2,17,8,34,29,1
ESP-La Liga,2425,Celta Vigo,Iago Aspas,ESP,"FW,MF",37-296,1987,18.5,13,8,4,5,4,8,20,40.0,12,17,1,16,7,20,5,0
ESP-La Liga,2425,Celta Vigo,Iker Losada,ESP,"FW,MF",23-296,2001,4.0,3,3,0,1,2,1,5,20.0,4,4,1,3,1,4,8,0
ESP-La Liga,2425,Celta Vigo,Ilaix Moriba,GUI,MF,22-125,2003,22.7,64,39,21,30,13,30,54,55.6,24,28,4,24,13,77,32,1
ESP-La Liga,2425,Celta Vigo,Iván Villar,ESP,GK,27-319,1997,4.0,0,0,0,0,0,0,0,,0,0,0,0,0,0,3,0
ESP-La Liga,2425,Celta Vigo,Jailson Siqueira,BRA,"DF,MF",29-259,1995,6.8,13,11,9,3,1,9,11,81.8,2,6,4,2,9,22,28,1
ESP-La Liga,2425,Celta Vigo,Javi Rodríguez,ESP,DF,21-332,2003,26.9,52,37,35,17,0,33,47,70.2,14,29,10,19,32,84,95,1
ESP-La Liga,2425,Celta Vigo,Javier Manquillo,ESP,DF,31-019,1994,5.7,7,5,4,3,0,2,10,20.0,8,5,3,2,7,14,14,0
ESP-La Liga,2425,Celta Vigo,Jonathan Bamba,CIV,"FW,MF",29-059,1996,9.0,12,7,4,6,2,5,12,41.7,7,6,0,6,5,17,6,0
ESP-La Liga,2425,Celta Vigo,Joseph Aidoo,GHA,DF,29-237,1995,0.0,1,0,1,0,0,0,0,,0,0,0,0,0,1,0,0
ESP-La Liga,2425,Celta Vigo,Luca de la Torre,USA,MF,27-001,1998,0.0,0,0,0,0,0,0,0,,0,0,0,0,0,0,0,0
ESP-La Liga,2425,Celta Vigo,Marcos Alonso,ESP,DF,34-147,1990,28.4,33,20,18,12,3,24,43,55.8,19,22,7,15,34,67,124,4
ESP-La Liga,2425,Celta Vigo,Mihailo Ristić,SRB,"DF,MF",29-205,1995,4.7,6,6,4,2,0,4,6,66.7,2,1,0,1,1,7,18,0
ESP-La Liga,2425,Celta Vigo,Pablo Durán,ESP,"FW,MF",23-364,2001,15.3,15,9,4,7,4,4,15,26.7,11,12,3,9,8,23,18,0
ESP-La Liga,2425,Celta Vigo,Sergio Carreira,ESP,"MF,DF",24-223,2000,17.4,28,16,16,6,6,14,25,56.0,11,19,2,17,17,45,37,0
ESP-La Liga,2425,Celta Vigo,Tadeo Allende,ARG,FW,26-093,1999,0.0,0,0,0,0,0,0,0,,0,0,0,0,0,0,0,0
ESP-La Liga,2425,Celta Vigo,Vicente Guaita,ESP,GK,38-134,1987,33.0,0,0,0,0,0,0,0,,0,0,0,0,0,0,21,2
ESP-La Liga,2425,Celta Vigo,Williot Swedberg,SWE,"FW,MF",21-112,2004,14.8,23,16,9,10,4,13,20,65.0,7,12,1,11,3,26,10,1
ESP-La Liga,2425,Celta Vigo,Yoel Lago,ESP,DF,21-060,2004,6.5,12,8,8,3,1,7,9,77.8,2,5,4,1,4,16,30,0
ESP-La Liga,2425,Celta Vigo,Óscar Mingueza,ESP,"MF,DF",26-011,1999,29.4,37,23,20,12,5,25,67,37.3,42,34,5,29,21,58,46,6
ESP-La Liga,2425,Espanyol,Alejo Véliz,ARG,FW,21-247,2003,12.1,1,1,0,1,0,1,6,16.7,5,11,2,9,4,5,22,1
ESP-La Liga,2425,Espanyol,Alex Král,CZE,MF,27-005,1998,29.8,55,37,28,24,3,16,29,55.2,13,34,14,20,28,83,50,2
ESP-La Liga,2425,Espanyol,Antoniu,ESP,"FW,MF",22-261,2002,11.4,21,10,9,8,4,9,21,42.9,12,14,2,12,8,29,11,1
ESP-La Liga,2425,Espanyol,Brian Oliván,ESP,DF,31-053,1994,11.3,13,10,7,6,0,4,13,30.8,9,6,2,4,10,23,23,0
ESP-La Liga,2425,Espanyol,Carlos Romero,ESP,DF,23-207,2001,27.4,66,43,45,14,7,41,78,52.6,37,49,14,35,29,95,99,1
ESP-La Liga,2425,Espanyol,Edu Expósito,ESP,MF,28-296,1996,11.0,23,13,9,13,1,9,22,40.9,13,3,0,3,14,37,21,2
ESP-La Liga,2425,Espanyol,Fernando Calero,ESP,"DF,MF",29-252,1995,6.9,16,9,12,4,0,6,10,60.0,4,14,8,6,15,31,41,1
ESP-La Liga,2425,Espanyol,Irvin Cardona,FRA,"FW,MF",27-289,1997,6.7,8,5,2,4,2,6,16,37.5,10,5,1,4,4,12,10,0
ESP-La Liga,2425,Espanyol,Javi Puado,ESP,"FW,MF",26-364,1998,32.0,21,16,13,4,4,8,19,42.1,11,15,2,13,5,26,19,0
ESP-La Liga,2425,Espanyol,Joan García,ESP,GK,24-020,2001,37.0,0,0,0,0,0,0,1,0.0,1,1,0,1,0,0,18,4
ESP-La Liga,2425,Espanyol,Jofre,ESP,"MF,FW",23-341,2001,23.5,22,16,14,5,3,13,23,56.5,10,13,0,13,15,37,29,0
ESP-La Liga,2425,Espanyol,José Gragera,ESP,MF,24-175,2000,6.3,25,16,11,14,0,9,17,52.9,8,9,1,8,5,30,13,0
ESP-La Liga,2425,Espanyol,Justin Smith,CAN,MF,22-109,2003,2.3,9,3,3,6,0,4,6,66.7,2,5,1,4,4,13,3,0
ESP-La Liga,2425,Espanyol,Leandro Cabrera,URU,DF,33-341,1991,30.9,39,22,28,8,3,18,32,56.3,14,35,25,10,30,69,195,2
ESP-La Liga,2425,Espanyol,Marash Kumbulla,ALB,DF,25-105,2000,33.0,51,26,35,14,2,24,41,58.5,17,48,35,13,34,85,224,2
ESP-La Liga,2425,Espanyol,Naci Ünüvar,NED,"MF,DF",21-345,2003,0.3,2,2,1,1,0,1,2,50.0,1,0,0,0,0,2,0,0
ESP-La Liga,2425,Espanyol,Omar El Hilali,MAR,DF,21-254,2003,34.0,110,79,80,24,6,63,93,67.7,30,53,13,40,45,155,141,2
ESP-La Liga,2425,Espanyol,Pere Milla,ESP,"MF,FW",32-243,1992,4.6,6,2,5,0,1,1,15,6.7,14,10,2,8,3,9,4,0
ESP-La Liga,2425,Espanyol,Pol Lozano,ESP,MF,25-230,1999,21.1,53,34,23,25,5,25,56,44.6,31,31,6,25,21,74,31,0
ESP-La Liga,2425,Espanyol,Rafael Bauza,ESP,MF,20-114,2005,2.0,5,3,3,1,1,4,7,57.1,3,3,1,2,0,5,5,0
ESP-La Liga,2425,Espanyol,Roberto Férnandez,ESP,FW,22-325,2002,15.8,4,4,2,1,1,0,5,0.0,5,8,1,7,3,7,26,0
ESP-La Liga,2425,Espanyol,Roger Hinojo,ESP,DF,20-092,2005,0.1,0,0,0,0,0,0,0,,0,0,0,0,0,0,1,0
ESP-La Liga,2425,Espanyol,Sergi Gómez,ESP,DF,33-057,1992,7.2,8,5,7,1,0,2,3,66.7,1,12,8,4,7,15,36,0
ESP-La Liga,2425,Espanyol,Urko González,ESP,MF,24-065,2001,14.4,42,25,24,17,1,25,40,62.5,15,27,12,15,8,50,36,1
ESP-La Liga,2425,Espanyol,Walid Cheddira,MAR,FW,27-122,1998,7.1,5,0,1,1,3,0,1,0.0,1,4,0,4,1,6,6,0
ESP-La Liga,2425,Espanyol,Álvaro Aguado,ESP,MF,29-023,1996,4.8,4,2,2,2,0,2,8,25.0,6,6,1,5,4,8,5,1
ESP-La Liga,2425,Espanyol,Álvaro Tejero,ESP,"MF,DF",28-308,1996,13.8,14,4,7,6,1,7,23,30.4,16,9,1,8,13,27,34,1
ESP-La Liga,2425,Getafe,Abdoulaye Keita,ESP,"FW,MF",22-265,2002,1.1,2,2,0,1,1,2,4,50.0,2,1,0,1,0,2,3,0
ESP-La Liga,2425,Getafe,Alberto Risco,ESP,"MF,FW",19-267,2005,0.8,4,4,2,0,2,1,6,16.7,5,2,0,2,0,4,0,0
ESP-La Liga,2425,Getafe,Alex Sola,ESP,"MF,FW",25-349,1999,11.4,21,14,9,12,0,9,25,36.0,16,8,0,8,7,28,11,1
ESP-La Liga,2425,Getafe,Allan Nyom,CMR,"DF,MF",37-014,1988,8.9,15,9,5,9,1,12,14,85.7,2,4,2,2,4,19,21,0
ESP-La Liga,2425,Getafe,Bertuğ Yıldırım,TUR,FW,22-316,2002,11.9,10,5,0,7,3,2,7,28.6,5,13,2,11,1,11,16,0
ESP-La Liga,2425,Getafe,Borja Mayoral,ESP,FW,28-049,1997,11.5,5,4,2,2,1,3,8,37.5,5,4,0,4,1,6,6,0
ESP-La Liga,2425,Getafe,Carles Aleñá,ESP,"MF,FW",27-139,1998,5.0,6,3,2,3,1,4,13,30.8,9,9,1,8,0,6,7,0
ESP-La Liga,2425,Getafe,Carles Pérez,ESP,"MF,FW",27-097,1998,15.9,33,23,11,14,8,21,48,43.8,27,19,2,17,6,39,22,0
ESP-La Liga,2425,Getafe,Christantus Uche,NGA,"FW,MF",22-005,2003,26.7,31,20,6,18,7,8,17,47.1,9,19,2,17,10,41,19,0
ESP-La Liga,2425,Getafe,Coba da Costa,ESP,"MF,FW",22-302,2002,11.1,29,13,9,16,4,13,26,50.0,13,24,0,24,8,37,10,0
ESP-La Liga,2425,Getafe,David Argüelles,ESP,MF,23-143,2002,0.1,0,0,0,0,0,0,0,,0,2,0,2,0,0,0,0
ESP-La Liga,2425,Getafe,David Soria,ESP,GK,32-050,1993,37.0,4,4,4,0,0,4,5,80.0,1,0,0,0,1,5,20,3
ESP-La Liga,2425,Getafe,Diego Rico,ESP,DF,32-090,1993,30.3,80,48,46,29,5,47,83,56.6,36,40,3,37,33,113,100,2
ESP-La Liga,2425,Getafe,Djené,TOG,"DF,MF",33-144,1991,27.3,25,13,12,11,2,12,31,38.7,19,18,8,10,21,46,104,3
ESP-La Liga,2425,Getafe,Domingos Duarte,POR,DF,30-075,1995,19.7,26,13,20,4,2,15,19,78.9,4,27,16,11,15,41,145,1
ESP-La Liga,2425,Getafe,Gorka Rivera Alonso,ESP,"DF,MF",20-296,2004,0.2,2,0,0,2,0,2,2,100.0,0,0,0,0,0,2,0,0
ESP-La Liga,2425,Getafe,Iglesias,ESP,DF,26-325,1998,31.1,81,47,42,33,6,46,89,51.7,43,46,7,39,48,129,128,1
ESP-La Liga,2425,Getafe,Ismael Bekhoucha,MAR,"MF,DF",20-185,2004,0.4,0,0,0,0,0,0,0,,0,0,0,0,2,2,1,0
ESP-La Liga,2425,Getafe,Jesús Santiago,ESP,MF,20-364,2004,3.6,14,8,6,8,0,5,9,55.6,4,6,2,4,1,15,3,0
ESP-La Liga,2425,Getafe,John Joe,IRL,"MF,FW",21-212,2003,0.5,0,0,0,0,0,0,0,,0,1,1,0,0,0,1,0
ESP-La Liga,2425,Getafe,Juan Bernat,ESP,"MF,DF",32-084,1993,7.8,19,13,9,5,5,7,12,58.3,5,9,3,6,2,21,12,0
ESP-La Liga,2425,Getafe,Juan Berrocal,ESP,DF,26-020,1999,11.3,14,7,10,4,0,10,14,71.4,4,6,3,3,13,27,56,0
ESP-La Liga,2425,Getafe,Juanmi,ESP,"FW,MF",32-004,1993,7.4,14,11,4,7,3,6,16,37.5,10,6,0,6,2,16,3,0
ESP-La Liga,2425,Getafe,Luis Milla,ESP,MF,30-229,1994,31.9,61,40,28,25,8,35,72,48.6,37,25,0,25,24,85,28,3
ESP-La Liga,2425,Getafe,Mauro Arambarri,URU,MF,29-236,1995,28.9,45,26,9,31,5,21,47,44.7,26,34,6,28,14,59,44,0
ESP-La Liga,2425,Getafe,Nabil Aberdin,FRA,MF,22-274,2002,2.9,6,4,3,3,0,1,1,100.0,0,3,0,3,0,6,5,0
ESP-La Liga,2425,Getafe,Omar Alderete,PAR,DF,28-149,1996,33.0,43,29,30,11,2,20,30,66.7,10,38,22,16,40,83,241,1
ESP-La Liga,2425,Getafe,Peter González,DOM,"MF,FW",22-303,2002,5.3,11,6,2,5,4,6,9,66.7,3,8,0,8,2,13,5,0
ESP-La Liga,2425,Getafe,Ramón Terrats,ESP,"MF,FW",24-218,2000,12.9,20,10,7,8,5,8,27,29.6,19,9,2,7,7,27,15,0
ESP-La Liga,2425,Getafe,Álvaro Rodríguez,URU,FW,20-314,2004,9.5,10,7,0,7,3,5,10,50.0,5,23,0,23,3,13,12,0
ESP-La Liga,2425,Girona,Abel Ruiz,ESP,FW,25-116,2000,14.8,6,2,2,2,2,2,5,40.0,3,7,2,5,5,11,7,0
ESP-La Liga,2425,Girona,Alejandro Francés,ESP,DF,22-296,2002,12.3,35,24,21,13,1,27,39,69.2,12,16,7,9,16,51,46,0
ESP-La Liga,2425,Girona,Arnau Martinez,ESP,"DF,MF",22-029,2003,28.2,51,28,30,15,6,32,61,52.5,29,17,6,11,29,80,75,2
ESP-La Liga,2425,Girona,Arnaut Danjuma,NED,"FW,MF",28-113,1997,14.8,8,6,3,3,2,2,7,28.6,5,5,1,4,2,10,4,0
ESP-La Liga,2425,Girona,Arthur Melo,BRA,MF,28-285,1996,9.7,25,11,8,12,5,14,26,53.8,12,5,1,4,7,32,11,1
ESP-La Liga,2425,Girona,Bojan Miovski,MKD,FW,25-334,1999,9.7,7,5,2,2,3,2,7,28.6,5,4,0,4,2,9,7,0
ESP-La Liga,2425,Girona,Bryan Gil,ESP,"FW,MF",24-102,2001,19.1,34,20,10,15,9,14,30,46.7,16,24,0,24,10,44,9,4
ESP-La Liga,2425,Girona,Cristhian Stuani,URU,FW,38-224,1986,11.0,9,7,1,7,1,5,8,62.5,3,4,1,3,5,14,9,0
ESP-La Liga,2425,Girona,Daley Blind,NED,DF,35-076,1990,29.9,47,25,24,19,4,30,47,63.8,17,30,8,22,29,76,90,1
ESP-La Liga,2425,Girona,David López,ESP,DF,35-227,1989,27.0,32,24,22,7,3,18,31,58.1,13,22,12,10,14,46,111,2
ESP-La Liga,2425,Girona,Donny van de Beek,NED,MF,28-036,1997,15.8,29,18,17,7,5,13,26,50.0,13,19,3,16,10,39,12,0
ESP-La Liga,2425,Girona,Ferrán Ruiz,ESP,MF,22-028,2003,0.2,0,0,0,0,0,0,0,,0,2,1,1,1,1,0,0
ESP-La Liga,2425,Girona,Gabriel Osei Misehouy,NED,"FW,MF",19-310,2005,2.9,1,1,0,1,0,0,1,0.0,1,0,0,0,0,1,0,0
ESP-La Liga,2425,Girona,Iker Almena,ESP,"FW,DF",21-020,2004,0.5,0,0,0,0,0,0,1,0.0,1,1,0,1,0,0,2,0
ESP-La Liga,2425,Girona,Iván Martín,ESP,MF,26-099,1999,22.4,32,19,14,14,4,15,34,44.1,19,18,5,13,11,43,15,1
ESP-La Liga,2425,Girona,Jhon Solis,COL,MF,20-233,2004,5.9,13,7,3,9,1,6,14,42.9,8,13,1,12,4,17,6,1
ESP-La Liga,2425,Girona,Juanpe,ESP,DF,34-024,1991,7.8,8,5,5,3,0,6,8,75.0,2,15,10,5,8,16,54,1
ESP-La Liga,2425,Girona,Kim Minsu,KOR,"MF,FW",19-125,2006,0.2,1,0,0,1,0,0,0,,0,0,0,0,0,1,0,0
ESP-La Liga,2425,Girona,Krapyvtsov Vladyslav,UKR,GK,19-333,2005,1.0,0,0,0,0,0,0,0,,0,0,0,0,0,0,0,0
ESP-La Liga,2425,Girona,Ladislav Krejčí,CZE,DF,26-034,1999,26.1,22,15,18,4,0,13,25,52.0,12,24,19,5,34,56,89,4
ESP-La Liga,2425,Girona,Miguel Gutiérrez,ESP,"DF,MF",23-301,2001,27.3,37,24,18,16,3,17,37,45.9,20,17,7,10,16,53,34,3
ESP-La Liga,2425,Girona,Oriol Romeu,ESP,MF,33-242,1991,14.9,36,23,13,18,5,14,26,53.8,12,21,7,14,12,48,20,3
ESP-La Liga,2425,Girona,Papa Ba,ESP,MF,20-254,2004,0.5,1,1,1,0,0,0,0,,0,1,0,1,0,1,1,0
ESP-La Liga,2425,Girona,Pau López,ESP,GK,30-162,1994,0.5,0,0,0,0,0,0,0,,0,0,0,0,0,0,1,0
ESP-La Liga,2425,Girona,Paulo Gazzaniga,ARG,GK,33-142,1992,35.5,1,1,1,0,0,1,1,100.0,0,1,0,1,0,1,17,3
ESP-La Liga,2425,Girona,Portu,ESP,"FW,MF",33-003,1992,8.0,13,7,5,5,3,7,10,70.0,3,8,0,8,0,13,2,0
ESP-La Liga,2425,Girona,Silvi Clúa,ESP,MF,20-115,2005,1.8,8,7,4,3,1,4,6,66.7,2,1,0,1,2,10,6,0
ESP-La Liga,2425,Girona,Viktor Tsyhankov,UKR,"FW,MF",27-190,1997,20.3,18,11,3,7,8,8,18,44.4,10,6,1,5,14,32,12,1
ESP-La Liga,2425,Girona,Yangel Herrera,VEN,MF,27-130,1998,24.3,63,38,30,26,7,30,58,51.7,28,21,5,16,31,94,49,2
ESP-La Liga,2425,Girona,Yaser Asprilla,COL,"FW,MF",21-186,2003,14.6,19,12,5,8,6,7,22,31.8,15,13,0,13,6,25,4,1
ESP-La Liga,2425,Las Palmas,Aboubacar Bassinga,CIV,MF,19-315,2005,0.0,0,0,0,0,0,0,0,,0,0,0,0,0,0,0,0
ESP-La Liga,2425,Las Palmas,Adnan Januzaj,BEL,"FW,MF",30-108,1995,6.1,10,6,1,6,3,5,8,62.5,3,6,0,6,2,12,3,0
ESP-La Liga,2425,Las Palmas,Alberto Moleiro,ESP,"FW,MF",21-236,2003,30.2,27,12,12,14,1,18,48,37.5,30,24,0,24,18,45,8,0
ESP-La Liga,2425,Las Palmas,Andy Pelmard,FRA,DF,25-073,2000,2.3,5,0,3,2,0,4,5,80.0,1,3,1,2,2,7,20,0
ESP-La Liga,2425,Las Palmas,Benito Ramírez,ESP,"DF,MF",29-317,1995,4.8,10,5,4,6,0,9,16,56.3,7,7,3,4,1,11,14,1
ESP-La Liga,2425,Las Palmas,Daley Sinkgraven,NED,DF,29-324,1995,1.0,5,1,3,2,0,1,3,33.3,2,1,0,1,1,6,2,0
ESP-La Liga,2425,Las Palmas,Dario Essugo,POR,MF,20-071,2005,20.8,58,44,28,25,5,27,45,60.0,18,28,11,17,42,100,46,7
ESP-La Liga,2425,Las Palmas,Diego Martín,ESP,FW,21-284,2003,0.1,1,1,0,0,1,1,1,100.0,0,0,0,0,0,1,0,0
ESP-La Liga,2425,Las Palmas,Dinko Horkaš,CRO,GK,26-075,1999,11.1,0,0,0,0,0,0,0,,0,0,0,0,0,0,8,1
ESP-La Liga,2425,Las Palmas,Enzo Loiodice,FRA,MF,24-178,2000,6.6,13,5,8,5,0,3,10,30.0,7,4,1,3,5,18,7,2
ESP-La Liga,2425,Las Palmas,Fabio González,ESP,MF,28-101,1997,0.6,0,0,0,0,0,0,1,0.0,1,0,0,0,0,0,0,0
ESP-La Liga,2425,Las Palmas,Fábio Silva,POR,FW,22-309,2002,20.7,12,7,4,5,3,4,14,28.6,10,12,0,12,4,16,27,0
ESP-La Liga,2425,Las Palmas,Jaime Mata,ESP,"FW,MF",36-212,1988,6.4,8,2,2,6,0,3,9,33.3,6,5,1,4,3,11,9,0
ESP-La Liga,2425,Las Palmas,Jasper Cillessen,NED,GK,36-032,1989,25.9,1,0,1,0,0,1,4,25.0,3,0,0,0,0,1,11,2
ESP-La Liga,2425,Las Palmas,Javier Muñoz,ESP,"MF,DF",30-085,1995,28.8,45,35,18,17,10,16,46,34.8,30,27,4,23,31,76,39,3
ESP-La Liga,2425,Las Palmas,José Campaña,ESP,MF,31-358,1993,13.2,21,16,8,11,2,11,20,55.0,9,9,1,8,19,40,19,2
ESP-La Liga,2425,Las Palmas,Juan Herzog,ESP,DF,22-011,2003,13.7,11,11,11,0,0,9,16,56.3,7,16,10,6,17,28,81,0
ESP-La Liga,2425,Las Palmas,Kirian Rodríguez,ESP,MF,29-080,1996,19.5,33,17,12,18,3,22,43,51.2,21,22,4,18,10,43,21,0
ESP-La Liga,2425,Las Palmas,Manuel Fuster,ESP,"FW,MF",27-214,1997,10.1,19,11,5,8,6,15,27,55.6,12,13,3,10,4,23,15,0
ESP-La Liga,2425,Las Palmas,Marc Cardona,ESP,"FW,DF",29-320,1995,1.5,4,2,1,3,0,0,1,0.0,1,0,0,0,0,4,0,0
ESP-La Liga,2425,Las Palmas,Marvin,ESP,"DF,FW",24-325,2000,10.5,24,12,11,9,4,10,25,40.0,15,15,5,10,13,37,27,0
ESP-La Liga,2425,Las Palmas,Mika Mármol,ESP,DF,23-327,2001,25.7,59,28,33,24,2,34,52,65.4,18,45,14,31,38,97,117,2
ESP-La Liga,2425,Las Palmas,Oliver McBurnie,SCO,FW,28-354,1996,20.3,15,7,5,8,2,5,12,41.7,7,15,5,10,6,21,24,0
ESP-La Liga,2425,Las Palmas,Pejiño,ESP,FW,28-299,1996,0.2,1,1,0,1,0,1,1,100.0,0,0,0,0,0,1,0,0
ESP-La Liga,2425,Las Palmas,Sandro Ramírez,ESP,"FW,MF",29-319,1995,22.6,27,15,10,13,4,13,30,43.3,17,20,0,20,16,43,22,2
ESP-La Liga,2425,Las Palmas,Scott McKenna,SCO,DF,28-193,1996,26.4,21,13,16,5,0,9,12,75.0,3,36,28,8,9,30,156,2
ESP-La Liga,2425,Las Palmas,Sergio Viera,ESP,MF,20-016,2005,0.4,0,0,0,0,0,0,1,0.0,1,1,0,1,0,0,1,0
ESP-La Liga,2425,Las Palmas,Stefan Bajcetic,ESP,"MF,DF",20-214,2004,10.8,29,14,13,13,3,12,28,42.9,16,25,4,21,15,44,26,1
ESP-La Liga,2425,Las Palmas,Valentín Pezzolesi,ESP,DF,18-038,2007,0.1,0,0,0,0,0,0,0,,0,0,0,0,0,0,1,1
ESP-La Liga,2425,Las Palmas,Viti,ESP,DF,27-250,1997,22.0,71,46,43,21,7,31,45,68.9,14,28,7,21,27,98,61,0
ESP-La Liga,2425,Las Palmas,Álex Muñoz,ESP,DF,30-298,1994,15.7,39,29,22,16,1,21,38,55.3,17,28,11,17,16,55,69,0
ESP-La Liga,2425,Las Palmas,Álex Suárez,ESP,DF,32-067,1993,27.3,40,23,30,9,1,20,27,74.1,7,39,24,15,13,53,107,2
ESP-La Liga,2425,Leganés,Adrià Altimira,ESP,"DF,FW",24-057,2001,17.1,40,23,25,12,3,23,38,60.5,15,14,6,8,15,55,50,2
ESP-La Liga,2425,Leganés,Aritz Arambarri,ESP,DF,27-113,1998,2.0,1,1,1,0,0,1,1,100.0,0,2,2,0,3,4,8,0
ESP-La Liga,2425,Leganés,Borna Barišić,CRO,DF,32-195,1992,0.1,0,0,0,0,0,0,0,,0,0,0,0,0,0,0,0
ESP-La Liga,2425,Leganés,Dani Raba,ESP,"FW,MF",29-207,1995,20.1,37,23,17,15,5,17,40,42.5,23,27,3,24,14,51,18,1
ESP-La Liga,2425,Leganés,Darko Brašanac,SRB,MF,33-101,1992,17.8,26,11,5,15,6,9,17,52.9,8,24,11,13,16,42,34,0
ESP-La Liga,2425,Leganés,Diego,ESP,FW,25-036,2000,13.0,1,1,0,0,1,1,7,14.3,6,4,1,3,2,3,11,0
ESP-La Liga,2425,Leganés,Duk,CPV,"MF,FW",25-097,2000,1.7,7,3,2,3,2,3,5,60.0,2,3,0,3,1,8,2,0
ESP-La Liga,2425,Leganés,Enric Franquesa,ESP,"DF,FW",28-087,1997,6.8,17,9,9,6,2,9,13,69.2,4,7,1,6,5,22,12,0
ESP-La Liga,2425,Leganés,Javi Hernández,ESP,DF,27-022,1998,25.5,25,15,16,6,3,16,44,36.4,28,25,5,20,23,48,96,0
ESP-La Liga,2425,Leganés,Jorge Sáenz,ESP,DF,28-188,1996,17.8,35,21,18,16,1,11,19,57.9,8,26,17,9,25,60,159,0
ESP-La Liga,2425,Leganés,Juan Cruz,ESP,"FW,MF",25-029,2000,24.1,31,19,14,15,2,17,34,50.0,17,14,2,12,11,42,31,0
ESP-La Liga,2425,Leganés,Juan Soriano,ESP,GK,27-274,1997,6.0,1,1,1,0,0,1,1,100.0,0,0,0,0,0,1,2,0
ESP-La Liga,2425,Leganés,Julián Chicco,ARG,"MF,DF",27-131,1998,3.3,11,7,3,6,2,5,8,62.5,3,2,0,2,3,14,9,0
ESP-La Liga,2425,Leganés,Marko Dmitrović,SRB,GK,33-120,1992,31.0,1,1,1,0,0,1,2,50.0,1,0,0,0,0,1,26,3
ESP-La Liga,2425,Leganés,Matija Nastasić,SRB,DF,32-057,1993,23.4,25,11,21,4,0,17,25,68.0,8,39,30,9,21,46,165,0
ESP-La Liga,2425,Leganés,Miguel,ESP,FW,25-263,1999,19.0,16,7,6,4,6,4,14,28.6,10,15,4,11,4,20,23,1
ESP-La Liga,2425,Leganés,Munir El Haddadi,MAR,"FW,MF",29-265,1995,8.9,12,9,5,4,3,3,12,25.0,9,8,1,7,1,13,1,1
ESP-La Liga,2425,Leganés,Renato Tapia,PER,"MF,DF",29-300,1995,26.0,60,34,29,27,4,23,48,47.9,25,58,23,35,27,87,86,2
ESP-La Liga,2425,Leganés,Roberto López,ESP,MF,25-030,2000,4.4,8,6,4,4,0,5,15,33.3,10,5,0,5,1,9,7,2
ESP-La Liga,2425,Leganés,Sergi,ESP,DF,33-034,1992,31.9,39,28,22,16,1,17,31,54.8,14,37,28,9,39,78,182,2
ESP-La Liga,2425,Leganés,Seydouba Cissé,GUI,MF,24-103,2001,26.2,57,36,18,26,13,23,47,48.9,24,25,1,24,12,69,45,1
ESP-La Liga,2425,Leganés,Sébastien Haller,CIV,FW,30-336,1994,4.5,2,0,1,0,1,1,2,50.0,1,1,0,1,0,2,7,0
ESP-La Liga,2425,Leganés,Valentin Rosier,FRA,DF,28-278,1996,28.8,72,52,48,16,8,43,68,63.2,25,40,15,25,52,124,149,2
ESP-La Liga,2425,Leganés,Yan Diomandé,CIV,"MF,FW",18-191,2006,5.4,10,5,1,4,5,2,11,18.2,9,8,0,8,7,17,5,0
ESP-La Liga,2425,Leganés,Yvan Neyou,CMR,MF,28-141,1997,25.7,53,33,21,26,6,22,47,46.8,25,35,5,30,26,79,38,1
ESP-La Liga,2425,Leganés,Óscar Rodríguez Arnaiz,ESP,"MF,FW",26-330,1998,14.8,32,17,10,16,6,14,32,43.8,18,10,1,9,20,52,20,0
ESP-La Liga,2425,Mallorca,Abdón Prats,ESP,"FW,MF",32-168,1992,5.1,2,1,1,1,0,1,2,50.0,1,2,1,1,1,3,5,0
ESP-La Liga,2425,Mallorca,Antonio Raillo,ESP,DF,33-228,1991,34.6,30,17,17,10,3,14,18,77.8,4,46,35,11,28,58,216,1
ESP-La Liga,2425,Mallorca,Antonio Sánchez,ESP,"MF,DF",28-143,1997,14.7,28,16,16,8,4,14,32,43.8,18,15,2,13,17,45,32,1
ESP-La Liga,2425,Mallorca,Chiquinho,POR,"MF,FW",25-108,2000,1.6,1,0,0,1,0,0,7,0.0,7,3,0,3,2,3,0,0
ESP-La Liga,2425,Mallorca,Copete,ESP,DF,25-226,1999,17.0,29,17,18,10,1,11,12,91.7,1,24,16,8,17,46,123,2
ESP-La Liga,2425,Mallorca,Cyle Larin,CAN,FW,30-037,1995,19.3,12,6,1,6,5,3,8,37.5,5,12,3,9,1,13,16,0
ESP-La Liga,2425,Mallorca,Dani Rodríguez,ESP,"MF,FW",36-352,1988,23.8,48,29,17,21,10,14,27,51.9,13,22,3,19,12,60,29,0
ESP-La Liga,2425,Mallorca,Daniel Luna,COL,MF,22-017,2003,0.2,0,0,0,0,0,0,0,,0,1,0,1,0,0,0,0
ESP-La Liga,2425,Mallorca,David López,ESP,DF,22-110,2003,0.9,1,1,1,0,0,1,1,100.0,0,0,0,0,1,2,3,0
ESP-La Liga,2425,Mallorca,Dominik Greif,SVK,GK,28-048,1997,30.0,0,0,0,0,0,0,0,,0,0,0,0,0,0,10,1
ESP-La Liga,2425,Mallorca,Jan Salas,ESP,MF,19-287,2005,0.3,2,1,1,1,0,1,1,100.0,0,0,0,0,0,2,0,0
ESP-La Liga,2425,Mallorca,Javier Llabrés,ESP,FW,22-255,2002,0.6,0,0,0,0,0,0,0,,0,1,0,1,0,0,0,0
ESP-La Liga,2425,Mallorca,Johan Mojica,COL,DF,32-276,1992,30.5,35,23,26,6,3,19,40,47.5,21,13,5,8,26,61,83,3
ESP-La Liga,2425,Mallorca,Leo Román,ESP,GK,24-322,2000,7.0,0,0,0,0,0,0,0,,0,0,0,0,0,0,6,0
ESP-La Liga,2425,Mallorca,Manu Morlanes,ESP,MF,26-132,1999,14.6,43,27,18,20,5,18,30,60.0,12,18,7,11,24,67,16,0
ESP-La Liga,2425,Mallorca,Marc Domenech,ESP,"FW,MF",19-143,2006,2.6,3,3,1,1,1,2,4,50.0,2,2,0,2,0,3,2,0
ESP-La Liga,2425,Mallorca,Martin Valjent,SVK,DF,29-164,1995,30.7,30,21,22,7,1,15,25,60.0,10,32,21,11,18,48,195,1
ESP-La Liga,2425,Mallorca,Mateu Morey,ESP,DF,25-083,2000,7.2,20,16,12,5,3,11,20,55.0,9,10,0,10,12,32,24,1
ESP-La Liga,2425,Mallorca,Omar Mascarell,EQG,MF,32-111,1993,21.4,26,13,13,12,1,14,34,41.2,20,31,19,12,49,75,57,3
ESP-La Liga,2425,Mallorca,Pablo Maffeo,ESP,DF,27-316,1997,26.3,60,40,43,14,3,34,46,73.9,12,32,11,21,25,85,103,1
ESP-La Liga,2425,Mallorca,Roberto Navarro,ESP,"MF,FW",23-042,2002,14.2,29,22,14,11,4,9,19,47.4,10,18,0,18,19,48,12,0
ESP-La Liga,2425,Mallorca,Samu Costa,POR,MF,24-178,2000,28.4,86,42,43,41,2,32,76,42.1,44,45,15,30,32,118,84,1
ESP-La Liga,2425,Mallorca,Sergi Darder,ESP,"MF,FW",31-153,1993,29.5,38,24,15,15,8,16,43,37.2,27,19,1,18,15,53,22,1
ESP-La Liga,2425,Mallorca,Siebe Van Der Heyden,BEL,"DF,MF",26-359,1998,1.1,1,1,0,1,0,0,0,,0,1,0,1,2,3,3,0
ESP-La Liga,2425,Mallorca,Takuma Asano,JPN,"FW,MF",30-195,1994,11.7,13,9,5,7,1,6,11,54.5,5,7,0,7,6,19,9,0
ESP-La Liga,2425,Mallorca,Toni Lato,ESP,DF,27-184,1997,6.0,16,10,6,4,6,6,10,60.0,4,8,4,4,5,21,30,0
ESP-La Liga,2425,Mallorca,Valery Fernández,ESP,"MF,FW",25-182,1999,3.4,8,7,3,2,3,5,7,71.4,2,3,1,2,0,8,1,0
ESP-La Liga,2425,Mallorca,Vedat Muriqi,KVX,FW,31-030,1994,22.2,7,5,3,2,2,3,7,42.9,4,6,1,5,7,14,42,0
ESP-La Liga,2425,Osasuna,Abel,ESP,DF,24-276,2000,22.7,59,35,28,24,7,37,59,62.7,22,29,4,25,18,77,63,2
ESP-La Liga,2425,Osasuna,Aimar Oroz,ESP,MF,23-178,2001,32.0,33,18,15,12,6,14,45,31.1,31,27,2,25,20,53,9,0
ESP-La Liga,2425,Osasuna,Aitor Fernández,ESP,GK,34-021,1991,1.0,0,0,0,0,0,0,0,,0,0,0,0,0,0,2,0
ESP-La Liga,2425,Osasuna,Ante Budimir,CRO,FW,33-306,1991,31.8,20,9,3,11,6,3,13,23.1,10,19,4,15,2,22,24,0
ESP-La Liga,2425,Osasuna,Bryan Zaragoza,ESP,"FW,MF",24-029,2001,19.5,13,9,8,4,1,6,21,28.6,15,10,0,10,4,17,8,0
ESP-La Liga,2425,Osasuna,Catena,ESP,DF,30-208,1994,33.2,46,28,34,10,2,27,43,62.8,16,39,25,14,34,80,214,2
ESP-La Liga,2425,Osasuna,Enzo Boyomo,CMR,DF,23-229,2001,32.2,66,42,45,17,4,29,37,78.4,8,34,19,15,44,110,133,3
ESP-La Liga,2425,Osasuna,Iker Benito,ESP,"FW,MF",22-287,2002,0.4,0,0,0,0,0,0,1,0.0,1,0,0,0,1,1,2,0
ESP-La Liga,2425,Osasuna,Iker Muñoz,ESP,MF,22-200,2002,6.3,5,2,3,2,0,3,8,37.5,5,8,2,6,4,9,11,1
ESP-La Liga,2425,Osasuna,Javi Martínez,ESP,MF,25-153,1999,0.1,0,0,0,0,0,0,0,,0,0,0,0,0,0,0,0
ESP-La Liga,2425,Osasuna,Jesús Areso,ESP,DF,25-326,1999,33.2,50,37,30,13,7,38,55,69.1,17,25,4,21,8,58,91,0
ESP-La Liga,2425,Osasuna,Jon Moncayola,ESP,MF,27-011,1998,23.3,70,41,29,33,8,31,60,51.7,29,34,3,31,11,81,20,0
ESP-La Liga,2425,Osasuna,Jorge Herrando,ESP,DF,24-085,2001,15.2,17,11,9,5,3,9,15,60.0,6,20,14,6,12,29,65,2
ESP-La Liga,2425,Osasuna,José Arnaiz,ESP,"MF,FW",30-039,1995,1.4,7,5,3,3,1,4,7,57.1,3,2,0,2,3,10,1,0
ESP-La Liga,2425,Osasuna,Juan Cruz Armada,ESP,DF,32-300,1992,15.9,26,14,11,13,2,15,24,62.5,9,14,4,10,9,35,63,0
ESP-La Liga,2425,Osasuna,Kike Barja,ESP,"FW,MF",28-053,1997,3.5,5,4,1,3,1,2,4,50.0,2,5,0,5,3,8,4,0
ESP-La Liga,2425,Osasuna,Lucas Torró,ESP,MF,30-309,1994,32.4,74,41,34,35,5,36,64,56.3,28,35,9,26,45,119,67,3
ESP-La Liga,2425,Osasuna,Moi Gómez,ESP,"MF,FW",30-335,1994,8.8,13,9,4,7,2,4,8,50.0,4,5,2,3,6,19,7,1
ESP-La Liga,2425,Osasuna,Nacho Vidal,ESP,DF,30-120,1995,1.4,2,0,0,1,1,1,4,25.0,3,1,0,1,0,2,6,0
ESP-La Liga,2425,Osasuna,Pablo Ibáñez,ESP,MF,26-246,1998,13.7,20,10,7,12,1,10,40,25.0,30,20,7,13,17,37,21,0
ESP-La Liga,2425,Osasuna,Raúl,ESP,"FW,MF",24-202,2000,8.0,13,8,3,6,4,5,10,50.0,5,4,0,4,0,13,6,0
ESP-La Liga,2425,Osasuna,Rubén García,ESP,"FW,MF",31-314,1993,25.8,50,30,19,21,10,25,57,43.9,32,35,3,32,14,64,33,1
ESP-La Liga,2425,Osasuna,Rubén Peña,ESP,"FW,DF",33-310,1991,8.6,12,5,4,3,5,5,24,20.8,19,11,0,11,6,18,12,0
ESP-La Liga,2425,Osasuna,Sergio Herrera,ESP,GK,31-353,1993,36.0,2,1,2,0,0,2,5,40.0,3,1,0,1,0,2,28,1
ESP-La Liga,2425,Osasuna,Unai García,ESP,DF,33-110,1992,0.7,0,0,0,0,0,0,0,,0,1,0,1,0,0,1,0
ESP-La Liga,2425,Rayo Vallecano,Abdul Mumin,GHA,DF,26-352,1998,22.4,37,25,30,7,0,17,27,63.0,10,40,29,11,23,60,125,0
ESP-La Liga,2425,Rayo Vallecano,Adri Embarba,ESP,"FW,MF",33-017,1992,17.8,41,20,17,17,7,18,46,39.1,28,17,1,16,13,54,14,2
ESP-La Liga,2425,Rayo Vallecano,Alfonso Espino,URU,DF,33-139,1992,9.3,41,24,31,8,2,26,47,55.3,21,19,6,13,12,53,32,1
ESP-La Liga,2425,Rayo Vallecano,Andrei Ratiu,ROU,DF,26-338,1998,33.1,70,40,40,20,10,42,69,60.9,27,43,5,38,27,97,71,2
ESP-La Liga,2425,Rayo Vallecano,Aridane Hernández,ESP,DF,36-062,1989,10.4,12,10,8,4,0,5,7,71.4,2,9,7,2,4,16,96,2
ESP-La Liga,2425,Rayo Vallecano,Augusto Batalla,ARG,GK,29-024,1996,31.0,4,2,4,0,0,4,6,66.7,2,0,0,0,0,4,13,4
ESP-La Liga,2425,Rayo Vallecano,Cárdenas,ESP,GK,28-057,1997,6.0,0,0,0,0,0,0,0,,0,0,0,0,0,0,3,0
ESP-La Liga,2425,Rayo Vallecano,Etienne Eto'o,CMR,FW,22-279,2002,0.4,0,0,0,0,0,0,1,0.0,1,0,0,0,0,0,1,0
ESP-La Liga,2425,Rayo Vallecano,Florian Lejeune,FRA,DF,34-004,1991,35.9,46,28,30,14,2,23,43,53.5,20,38,32,6,39,85,174,1
ESP-La Liga,2425,Rayo Vallecano,Gerard Gumbau,ESP,MF,30-157,1994,9.1,17,12,8,7,2,7,15,46.7,8,12,4,8,5,22,13,0
ESP-La Liga,2425,Rayo Vallecano,Isaac Palazón Camacho,ESP,"MF,FW",30-148,1994,23.0,22,17,10,6,6,8,33,24.2,25,21,2,19,8,30,13,1
ESP-La Liga,2425,Rayo Vallecano,Iván Balliu,ALB,DF,33-143,1992,12.7,17,14,8,5,4,6,18,33.3,12,16,4,12,13,30,39,0
ESP-La Liga,2425,Rayo Vallecano,James Rodríguez,COL,"MF,FW",33-316,1991,1.6,3,2,1,2,0,0,2,0.0,2,2,0,2,1,4,0,0
ESP-La Liga,2425,Rayo Vallecano,Jorge de Frutos,ESP,"FW,MF",28-093,1997,26.7,37,21,16,13,8,14,46,30.4,32,21,0,21,19,56,24,1
ESP-La Liga,2425,Rayo Vallecano,Pathé Ciss,SEN,"MF,DF",31-069,1994,22.8,46,23,24,21,1,20,40,50.0,20,31,10,21,37,83,60,3
ESP-La Liga,2425,Rayo Vallecano,Pedro Díaz,ESP,MF,26-353,1998,13.0,21,13,6,13,2,12,39,30.8,27,15,0,15,6,27,7,1
ESP-La Liga,2425,Rayo Vallecano,Pelayo Fernandez,ESP,DF,22-025,2003,1.1,0,0,0,0,0,0,0,,0,0,0,0,2,2,9,0
ESP-La Liga,2425,Rayo Vallecano,Pep Chavarría,ESP,"DF,FW",27-044,1998,27.7,43,33,29,13,1,27,44,61.4,17,35,9,26,28,71,107,1
ESP-La Liga,2425,Rayo Vallecano,Randy Nteka,ANG,FW,27-169,1997,12.5,16,5,3,9,4,5,12,41.7,7,13,2,11,4,20,20,0
ESP-La Liga,2425,Rayo Vallecano,Raúl de Tomás,ESP,"DF,FW",30-219,1994,0.2,2,2,1,0,1,0,0,,0,0,0,0,0,2,0,0
ESP-La Liga,2425,Rayo Vallecano,Sergi Guardiola,ESP,FW,33-360,1991,4.0,5,3,0,5,0,2,3,66.7,1,1,0,1,1,6,2,0
ESP-La Liga,2425,Rayo Vallecano,Sergio Camello,ESP,FW,24-103,2001,12.6,9,3,2,5,2,4,6,66.7,2,8,1,7,4,13,16,0
ESP-La Liga,2425,Rayo Vallecano,Unai López,ESP,MF,29-206,1995,18.4,28,20,13,10,5,15,34,44.1,19,17,6,11,21,49,20,0
ESP-La Liga,2425,Rayo Vallecano,Álvaro García,ESP,"FW,MF",32-209,1992,27.4,33,24,19,8,6,12,29,41.4,17,31,0,31,31,64,42,1
ESP-La Liga,2425,Rayo Vallecano,Óscar Trejo,ARG,MF,37-028,1988,5.5,8,5,1,5,2,3,9,33.3,6,9,0,9,4,12,5,0
ESP-La Liga,2425,Rayo Vallecano,Óscar Valentín,ESP,MF,30-277,1994,20.4,55,41,21,20,14,33,76,43.4,43,36,8,28,21,76,51,2
ESP-La Liga,2425,Real Madrid,Andriy Lunin,UKR,GK,26-102,1999,6.0,0,0,0,0,0,0,0,,0,0,0,0,0,0,2,0
ESP-La Liga,2425,Real Madrid,Antonio Rüdiger,GER,DF,32-082,1993,25.5,20,13,14,6,0,11,15,73.3,4,22,14,8,9,29,96,1
ESP-La Liga,2425,Real Madrid,Arda Güler,TUR,"MF,FW",20-088,2005,12.9,27,14,9,7,11,8,21,38.1,13,17,0,17,6,33,8,0
ESP-La Liga,2425,Real Madrid,Aurélien Tchouaméni,FRA,"DF,MF",25-117,2000,29.3,47,23,25,19,3,21,40,52.5,19,34,25,9,45,92,89,1
ESP-La Liga,2425,Real Madrid,Brahim Díaz,MAR,"FW,MF",25-294,1999,14.8,25,19,9,13,3,7,18,38.9,11,16,1,15,4,29,2,1
ESP-La Liga,2425,Real Madrid,Chema,ESP,MF,20-029,2005,0.1,0,0,0,0,0,0,0,,0,0,0,0,0,0,1,0
ESP-La Liga,2425,Real Madrid,Dani Carvajal,ESP,DF,33-133,1992,6.8,12,8,7,3,2,9,12,75.0,3,8,3,5,10,22,19,1
ESP-La Liga,2425,Real Madrid,Dani Ceballos,ESP,MF,28-290,1996,12.5,39,20,16,17,6,18,33,54.5,15,15,3,12,13,52,10,2
ESP-La Liga,2425,Real Madrid,Daniel Yáñez,ESP,FW,18-057,2007,0.0,0,0,0,0,0,0,0,,0,0,0,0,0,0,0,0
ESP-La Liga,2425,Real Madrid,David Alaba,AUT,DF,32-334,1992,3.5,1,0,1,0,0,0,0,,0,5,5,0,6,7,7,0
ESP-La Liga,2425,Real Madrid,Eduardo Camavinga,FRA,"MF,DF",22-195,2002,12.2,42,26,23,16,3,19,33,57.6,14,24,8,16,18,60,23,0
ESP-La Liga,2425,Real Madrid,Endrick,BRA,FW,18-307,2006,4.0,1,1,1,0,0,1,3,33.3,2,0,0,0,4,5,1,0
ESP-La Liga,2425,Real Madrid,Federico Valverde,URU,"MF,DF",26-306,1998,32.7,48,28,21,22,5,27,40,67.5,13,37,7,30,53,101,51,1
ESP-La Liga,2425,Real Madrid,Ferland Mendy,FRA,DF,29-350,1995,11.2,17,14,7,6,4,9,12,75.0,3,11,4,7,9,26,8,1
ESP-La Liga,2425,Real Madrid,Fran,ESP,GK,19-334,2005,1.0,0,0,0,0,0,0,0,,0,0,0,0,0,0,2,0
ESP-La Liga,2425,Real Madrid,Fran Garcia,ESP,DF,25-283,1999,23.1,47,33,27,15,5,26,45,57.8,19,25,5,20,28,75,66,1
ESP-La Liga,2425,Real Madrid,Gonzalo García,ESP,"DF,FW",21-061,2004,0.5,0,0,0,0,0,0,0,,0,1,0,1,0,0,0,0
ESP-La Liga,2425,Real Madrid,Jacobo Ramón,ESP,DF,20-138,2005,2.3,7,3,4,3,0,2,2,100.0,0,1,0,1,3,10,8,2
ESP-La Liga,2425,Real Madrid,Jesús Vallejo,ESP,DF,28-139,1997,1.1,0,0,0,0,0,0,0,,0,0,0,0,2,2,8,0
ESP-La Liga,2425,Real Madrid,Jude Bellingham,ENG,MF,21-329,2003,27.6,61,33,20,27,14,28,42,66.7,14,37,2,35,28,89,23,1
ESP-La Liga,2425,Real Madrid,Kylian Mbappé,FRA,FW,26-155,1998,31.3,8,5,1,3,4,1,5,20.0,4,3,0,3,1,9,1,1
ESP-La Liga,2425,Real Madrid,Lorenzo Aguado,ESP,DF,22-247,2002,0.1,0,0,0,0,0,0,0,,0,0,0,0,0,0,2,0
ESP-La Liga,2425,Real Madrid,Lucas Vázquez,ESP,DF,33-327,1991,23.5,57,34,33,17,7,26,47,55.3,21,22,5,17,17,74,33,1
ESP-La Liga,2425,Real Madrid,Luka Modrić,CRO,MF,39-257,1985,19.3,31,20,16,13,2,14,32,43.8,18,16,5,11,26,57,17,0
ESP-La Liga,2425,Real Madrid,Raúl Asencio,ESP,DF,22-100,2003,17.6,21,15,18,3,0,10,13,76.9,3,9,5,4,14,35,85,2
ESP-La Liga,2425,Real Madrid,Rodrygo,BRA,"FW,MF",24-135,2001,21.4,21,14,14,5,2,7,23,30.4,16,18,1,17,11,32,9,0
ESP-La Liga,2425,Real Madrid,Thibaut Courtois,BEL,GK,33-013,1992,30.0,0,0,0,0,0,0,0,,0,0,0,0,1,1,15,1
ESP-La Liga,2425,Real Madrid,Vinicius Júnior,BRA,FW,24-316,2000,24.6,21,10,7,4,10,5,18,27.8,13,7,0,7,3,24,1,2
ESP-La Liga,2425,Real Madrid,Víctor Muñoz,ESP,"FW,DF",21-315,2003,0.4,0,0,0,0,0,0,0,,0,0,0,0,0,0,0,0
ESP-La Liga,2425,Real Madrid,Éder Militão,BRA,DF,27-126,1998,10.4,19,17,14,5,0,7,12,58.3,5,13,8,5,12,31,35,0
ESP-La Liga,2425,Real Sociedad,Aihen Muñoz,ESP,DF,27-281,1997,11.2,23,12,13,8,2,13,27,48.1,14,11,6,5,13,36,45,0
ESP-La Liga,2425,Real Sociedad,Ander Barrenetxea,ESP,"MF,FW",23-148,2001,13.8,25,18,7,13,5,6,23,26.1,17,15,0,15,11,36,16,1
ESP-La Liga,2425,Real Sociedad,Aritz Elustondo,ESP,DF,31-057,1994,16.2,20,11,15,3,2,11,19,57.9,8,17,12,5,11,31,96,0
ESP-La Liga,2425,Real Sociedad,Arkaitz Mariezkurrena,ESP,"FW,MF",20-049,2005,1.9,1,0,1,0,0,0,4,0.0,4,2,0,2,1,2,3,0
ESP-La Liga,2425,Real Sociedad,Arsen Zakharyan,RUS,"MF,FW",21-363,2003,0.8,1,1,1,0,0,1,1,100.0,0,1,1,0,1,2,0,0
ESP-La Liga,2425,Real Sociedad,Beñat Turrientes,ESP,MF,23-113,2002,9.7,14,6,4,9,1,4,14,28.6,10,14,2,12,5,19,12,0
ESP-La Liga,2425,Real Sociedad,Brais Méndez,ESP,MF,28-137,1997,16.9,24,13,6,14,4,9,24,37.5,15,14,1,13,7,31,16,1
ESP-La Liga,2425,Real Sociedad,Daniel Díaz,ESP,MF,18-336,2006,0.1,1,1,1,0,0,0,0,,0,1,0,1,0,1,0,0
ESP-La Liga,2425,Real Sociedad,Hamari Traoré,MLI,DF,33-117,1992,7.8,19,12,10,7,2,15,22,68.2,7,6,2,4,9,28,21,0
ESP-La Liga,2425,Real Sociedad,Igor Zubeldia,ESP,DF,28-055,1997,25.2,34,22,21,10,3,14,26,53.8,12,32,18,14,31,65,100,2
ESP-La Liga,2425,Real Sociedad,Javi López,ESP,DF,23-060,2002,21.5,40,23,23,12,5,23,37,62.2,14,21,7,14,11,51,59,2
ESP-La Liga,2425,Real Sociedad,Jon Aramburu,VEN,DF,22-305,2002,26.3,95,68,56,29,10,63,96,65.6,33,38,8,30,28,123,96,0
ESP-La Liga,2425,Real Sociedad,Jon Magunazelaia,ESP,MF,23-315,2001,0.1,1,1,1,0,0,0,0,,0,0,0,0,0,1,0,0
ESP-La Liga,2425,Real Sociedad,Jon Martin,ESP,DF,19-143,2006,9.0,10,8,6,3,1,6,9,66.7,3,12,8,4,7,17,68,1
ESP-La Liga,2425,Real Sociedad,Jon Pacheco,ESP,DF,24-136,2001,8.5,13,9,10,3,0,8,10,80.0,2,8,6,2,8,21,45,2
ESP-La Liga,2425,Real Sociedad,Luka Sučić,CRO,MF,22-258,2002,19.0,24,17,7,12,5,9,24,37.5,15,29,2,27,13,37,15,1
ESP-La Liga,2425,Real Sociedad,Luken Beitia,ESP,DF,20-328,2004,0.1,1,1,1,0,0,1,1,100.0,0,0,0,0,0,1,2,0
ESP-La Liga,2425,Real Sociedad,Martín Zubimendi,ESP,MF,26-111,1999,32.7,73,37,31,29,13,28,44,63.6,16,41,16,25,44,117,78,3
ESP-La Liga,2425,Real Sociedad,Mikel Oyarzabal,ESP,FW,28-033,1997,24.8,24,15,8,10,6,10,23,43.5,13,17,1,16,4,28,15,0
ESP-La Liga,2425,Real Sociedad,Nayef Aguerd,MAR,DF,29-055,1996,19.6,30,24,17,12,1,12,18,66.7,6,21,15,6,13,43,91,0
ESP-La Liga,2425,Real Sociedad,Olasagasti,ESP,MF,24-281,2000,9.0,19,9,5,9,5,7,17,41.2,10,8,2,6,14,33,10,0
ESP-La Liga,2425,Real Sociedad,Orri Steinn Óskarsson,ISL,FW,20-268,2004,10.5,6,6,2,1,3,2,8,25.0,6,10,1,9,2,8,11,0
ESP-La Liga,2425,Real Sociedad,Pablo Marín,ESP,MF,21-325,2003,13.3,24,16,5,13,6,9,18,50.0,9,12,3,9,4,28,14,0
ESP-La Liga,2425,Real Sociedad,Sergio Gómez,ESP,"MF,DF",24-262,2000,29.6,70,39,29,29,12,30,55,54.5,25,44,3,41,18,88,29,2
ESP-La Liga,2425,Real Sociedad,Sheraldo Becker,SUR,"FW,MF",30-104,1995,11.1,3,2,0,3,0,0,2,0.0,2,4,0,4,1,4,10,0
ESP-La Liga,2425,Real Sociedad,Takefusa Kubo,JPN,"MF,FW",23-354,2001,25.4,30,19,10,11,9,16,39,41.0,23,35,1,34,15,45,13,1
ESP-La Liga,2425,Real Sociedad,Umar Sadiq,NGA,FW,28-111,1997,2.5,2,1,1,1,0,1,2,50.0,1,3,1,2,1,3,2,0
ESP-La Liga,2425,Real Sociedad,Unai Marrero,ESP,GK,23-227,2001,1.0,0,0,0,0,0,0,0,,0,0,0,0,0,0,1,0
ESP-La Liga,2425,Real Sociedad,Urko González,ESP,MF,24-065,2001,0.5,0,0,0,0,0,0,0,,0,1,1,0,0,0,0,0
ESP-La Liga,2425,Real Sociedad,Álex Remiro,ESP,GK,30-061,1995,36.0,1,0,1,0,0,1,2,50.0,1,0,0,0,0,1,18,4
ESP-La Liga,2425,Real Sociedad,Álvaro Odriozola,ESP,DF,29-161,1995,0.5,1,1,1,0,0,0,0,,0,0,0,0,0,1,1,0
ESP-La Liga,2425,Sevilla,Adrià Pedrosa,ESP,DF,27-011,1998,24.5,55,32,33,16,6,30,53,56.6,23,42,11,31,22,77,81,0
ESP-La Liga,2425,Sevilla,Akor Adams,NGA,FW,25-115,2000,1.5,0,0,0,0,0,0,0,,0,1,0,1,0,0,1,0
ESP-La Liga,2425,Sevilla,Albert Sambi Lokonga,BEL,MF,25-214,1999,16.3,22,15,10,9,3,10,14,71.4,4,13,1,12,9,31,24,3
ESP-La Liga,2425,Sevilla,Carmona,ESP,DF,23-115,2002,32.0,82,58,52,21,9,40,74,54.1,34,35,10,25,68,150,92,3
ESP-La Liga,2425,Sevilla,Chidera Ejuke,NGA,FW,27-142,1998,10.7,19,13,8,9,2,9,20,45.0,11,12,0,12,5,24,8,0
ESP-La Liga,2425,Sevilla,Darío Fuentes,ESP,DF,22-132,2003,0.1,0,0,0,0,0,0,0,,0,0,0,0,0,0,0,0
ESP-La Liga,2425,Sevilla,Diego Iturralde,ESP,FW,22-038,2003,0.4,0,0,0,0,0,0,0,,0,0,0,0,1,1,1,0
ESP-La Liga,2425,Sevilla,Djibril Sow,SUI,MF,28-107,1997,22.4,23,13,12,9,2,8,17,47.1,9,18,3,15,26,49,26,1
ESP-La Liga,2425,Sevilla,Dodi Lukebakio,BEL,FW,27-242,1997,33.9,22,14,8,8,6,15,27,55.6,12,18,1,17,8,30,17,2
ESP-La Liga,2425,Sevilla,Gonzalo Montiel,ARG,"DF,MF",28-143,1997,1.3,4,2,3,1,0,3,4,75.0,1,0,0,0,2,6,11,0
ESP-La Liga,2425,Sevilla,Isaac Romero,ESP,FW,25-006,2000,24.0,13,7,4,4,5,3,16,18.8,13,18,1,17,7,20,27,0
ESP-La Liga,2425,Sevilla,Israel Domínguez,ESP,FW,22-017,2003,0.2,0,0,0,0,0,0,0,,0,0,0,0,0,0,0,0
ESP-La Liga,2425,Sevilla,Jesús Navas,ESP,"FW,MF",39-184,1985,4.7,5,2,3,0,2,0,3,0.0,3,1,0,1,4,9,6,0
ESP-La Liga,2425,Sevilla,Juanlu Sánchez,ESP,"MF,DF",21-282,2003,18.3,49,34,27,15,7,34,55,61.8,21,27,2,25,16,65,19,0
ESP-La Liga,2425,Sevilla,Kelechi Iheanacho,NGA,FW,28-233,1996,4.4,1,0,0,1,0,1,3,33.3,2,0,0,0,0,1,1,0
ESP-La Liga,2425,Sevilla,Kike Salas,ESP,DF,23-031,2002,23.9,47,28,24,16,7,27,44,61.4,17,25,14,11,32,79,143,0
ESP-La Liga,2425,Sevilla,Leandro Antonetti,PUR,FW,22-131,2003,0.3,0,0,0,0,0,0,0,,0,0,0,0,0,0,0,0
ESP-La Liga,2425,Sevilla,Loïc Bade,FRA,DF,25-043,2000,29.8,47,27,37,10,0,23,31,74.2,8,22,13,9,29,76,162,2
ESP-La Liga,2425,Sevilla,Lucas Ocampos,ARG,FW,30-317,1994,1.9,3,2,2,0,1,1,2,50.0,1,2,0,2,0,3,2,0
ESP-La Liga,2425,Sevilla,Lucien Agoume,FRA,MF,23-104,2002,22.5,67,30,22,36,9,26,38,68.4,12,28,10,18,40,107,40,0
ESP-La Liga,2425,Sevilla,Manu Bueno,ESP,MF,20-301,2004,1.4,4,3,0,1,3,1,2,50.0,1,0,0,0,0,4,2,0
ESP-La Liga,2425,Sevilla,Marcão,BRA,DF,28-353,1996,5.1,9,6,6,3,0,2,3,66.7,1,9,6,3,6,15,27,1
ESP-La Liga,2425,Sevilla,Mateo Mejía,ESP,FW,22-054,2003,0.1,0,0,0,0,0,0,0,,0,0,0,0,0,0,0,0
ESP-La Liga,2425,Sevilla,Nemanja Gudelj,SRB,"DF,MF",33-189,1991,26.7,42,24,16,22,4,21,34,61.8,13,27,10,17,27,69,93,1
ESP-La Liga,2425,Sevilla,Peque,ESP,"MF,FW",22-232,2002,12.3,16,5,4,10,2,7,16,43.8,9,16,0,16,8,24,5,0
ESP-La Liga,2425,Sevilla,Ramón Martínez,ESP,DF,22-214,2002,2.6,5,3,4,1,0,2,3,66.7,1,2,1,1,2,7,22,0
ESP-La Liga,2425,Sevilla,Ruben Vargas,SUI,"FW,MF",26-292,1998,7.5,7,4,1,5,1,3,8,37.5,5,9,0,9,3,10,10,0
ESP-La Liga,2425,Sevilla,Saúl Ñíguez,ESP,MF,30-184,1994,17.3,47,32,16,24,7,12,31,38.7,19,25,2,23,22,69,34,0
ESP-La Liga,2425,Sevilla,Stanis Idumbo,BEL,"FW,MF",19-329,2005,3.2,9,5,3,4,2,3,5,60.0,2,3,1,2,4,13,2,0
ESP-La Liga,2425,Sevilla,Suso,ESP,"FW,MF",31-186,1993,5.8,9,6,3,6,0,3,8,37.5,5,3,0,3,4,13,2,0
ESP-La Liga,2425,Sevilla,Tanguy Nianzou,FRA,DF,22-351,2002,5.8,7,5,6,0,1,5,6,83.3,1,1,0,1,8,15,27,0
ESP-La Liga,2425,Sevilla,Valentín Barco,ARG,"DF,FW",20-305,2004,3.2,15,9,8,3,4,12,15,80.0,3,0,0,0,2,17,5,0
ESP-La Liga,2425,Sevilla,Álvaro Fernández,ESP,GK,27-041,1998,7.3,0,0,0,0,0,0,1,0.0,1,0,0,0,0,0,7,0
ESP-La Liga,2425,Sevilla,Álvaro Pascual,ESP,FW,23-143,2002,3.8,1,1,0,0,1,1,2,50.0,1,0,0,0,2,3,0,0
ESP-La Liga,2425,Sevilla,Ørjan Nyland,NOR,GK,34-256,1990,29.7,3,2,3,0,0,3,5,60.0,2,0,0,0,0,3,12,4
ESP-La Liga,2425,Valencia,Alberto Marí,ESP,FW,23-317,2001,0.1,0,0,0,0,0,0,0,,0,0,0,0,0,0,0,0
ESP-La Liga,2425,Valencia,Cristhian Mosquera,ESP,DF,20-331,2004,36.9,55,35,41,12,2,31,40,77.5,9,37,24,13,35,90,128,4
ESP-La Liga,2425,Valencia,César Tárrega,ESP,DF,23-087,2002,33.6,49,37,33,13,3,19,31,61.3,12,41,20,21,22,71,222,2
ESP-La Liga,2425,Valencia,Dani Gómez,ESP,FW,26-298,1998,5.9,3,2,0,0,3,0,0,,0,1,0,1,2,5,4,0
ESP-La Liga,2425,Valencia,David Otorbi,ESP,MF,17-220,2007,0.2,0,0,0,0,0,0,0,,0,1,0,1,0,0,0,0
ESP-La Liga,2425,Valencia,Diego López,ESP,"MF,FW",23-011,2002,30.4,31,18,11,16,4,16,47,34.0,31,30,0,30,16,47,16,0
ESP-La Liga,2425,Valencia,Dimitri Foulquier,FRA,DF,32-062,1993,25.5,48,31,29,13,6,24,36,66.7,12,21,5,16,16,64,86,1
ESP-La Liga,2425,Valencia,Domingos André Ribeiro Almeida,POR,"MF,FW",24-359,2000,22.0,48,32,18,21,9,14,39,35.9,25,21,3,18,8,56,14,1
ESP-La Liga,2425,Valencia,Enzo Barrenechea,ARG,MF,24-002,2001,24.3,58,30,23,29,6,32,46,69.6,14,30,8,22,28,86,48,1
ESP-La Liga,2425,Valencia,Francisco Perez,ESP,"FW,MF",22-257,2002,6.3,17,12,7,8,2,10,16,62.5,6,8,1,7,3,20,6,0
ESP-La Liga,2425,Valencia,Germán Valera,ESP,MF,23-069,2002,1.6,1,1,1,0,0,0,1,0.0,1,2,0,2,4,5,2,1
ESP-La Liga,2425,Valencia,Giorgi Mamardashvili,GEO,GK,24-237,2000,34.0,2,2,2,0,0,2,3,66.7,1,0,0,0,1,3,16,3
ESP-La Liga,2425,Valencia,Hugo Duro,ESP,FW,25-195,1999,24.1,13,8,4,7,2,5,13,38.5,8,11,2,9,10,23,11,0
ESP-La Liga,2425,Valencia,Hugo Guillamón,ESP,MF,25-113,2000,4.0,11,8,1,9,1,9,10,90.0,1,4,1,3,5,16,9,1
ESP-La Liga,2425,Valencia,Iker Córdoba,ESP,DF,19-194,2005,0.2,0,0,0,0,0,0,0,,0,0,0,0,0,0,1,0
ESP-La Liga,2425,Valencia,Ivan Jaime Pajuelo,ESP,MF,24-240,2000,3.3,8,5,2,3,3,4,5,80.0,1,2,0,2,2,10,0,0
ESP-La Liga,2425,Valencia,Javier Guerra,ESP,MF,22-143,2003,28.7,50,27,18,21,11,26,56,46.4,30,15,3,12,20,70,49,3
ESP-La Liga,2425,Valencia,Jesus Vazquez,ESP,DF,22-142,2003,10.2,23,18,12,9,2,10,19,52.6,9,16,5,11,10,33,30,0
ESP-La Liga,2425,Valencia,José Luis García Vayá,ESP,MF,26-286,1998,19.4,43,25,24,13,6,19,33,57.6,14,23,6,17,19,62,42,0
ESP-La Liga,2425,Valencia,José Luis Gayà,ESP,DF,29-364,1995,20.0,57,40,39,15,3,40,58,69.0,18,16,2,14,25,82,61,0
ESP-La Liga,2425,Valencia,Luis Rioja,ESP,"MF,FW",31-220,1993,31.5,33,21,14,12,7,14,42,33.3,28,30,1,29,22,55,44,1
ESP-La Liga,2425,Valencia,Martín Tejón,ESP,"MF,DF",21-042,2004,0.5,2,0,0,2,0,1,2,50.0,1,0,0,0,0,2,0,0
ESP-La Liga,2425,Valencia,Max Aarons,ENG,"DF,MF",25-140,2000,1.3,4,4,2,2,0,4,5,80.0,1,1,0,1,0,4,3,0
ESP-La Liga,2425,Valencia,Maximiliano Caufriez,BEL,DF,28-097,1997,1.0,1,1,1,0,0,1,1,100.0,0,2,1,1,1,2,4,0
ESP-La Liga,2425,Valencia,Mouctar Diakhaby,GUI,DF,28-156,1996,7.3,8,3,8,0,0,4,6,66.7,2,8,6,2,11,19,57,0
ESP-La Liga,2425,Valencia,Rafa Mir,ESP,"FW,MF",27-340,1997,8.4,12,6,8,4,0,3,9,33.3,6,5,0,5,5,17,9,0
ESP-La Liga,2425,Valencia,Rodrigo Abajas,ESP,DF,22-012,2003,0.7,3,2,2,1,0,3,3,100.0,0,1,0,1,1,4,0,0
ESP-La Liga,2425,Valencia,Sergi Canós,ESP,"MF,FW",28-111,1997,4.1,11,7,3,4,4,4,10,40.0,6,6,1,5,5,16,5,0
ESP-La Liga,2425,Valencia,Stole Dimitrievski,MKD,GK,31-150,1993,4.0,0,0,0,0,0,0,0,,0,0,0,0,0,0,3,1
ESP-La Liga,2425,Valencia,Thierry Correia,POR,DF,26-076,1999,8.5,27,18,19,5,3,13,23,56.5,10,10,1,9,4,31,18,0
ESP-La Liga,2425,Valencia,Umar Sadiq,NGA,FW,28-111,1997,9.2,10,5,3,5,2,4,6,66.7,2,7,0,7,1,11,7,0
ESP-La Liga,2425,Valencia,Yarek Gasiorowski,ESP,DF,20-132,2005,10.5,19,16,16,3,0,9,13,69.2,4,17,6,11,26,45,60,0
ESP-La Liga,2425,Valladolid,Adam Aznou,MAR,DF,18-356,2006,9.7,28,21,20,8,0,21,43,48.8,22,24,8,16,10,38,30,0
ESP-La Liga,2425,Valladolid,Adrian Baquerin,ESP,FW,18-081,2007,0.3,0,0,0,0,0,0,0,,0,0,0,0,0,0,1,0
ESP-La Liga,2425,Valladolid,Amath,SEN,"FW,DF",28-312,1996,4.0,2,0,2,0,0,1,7,14.3,6,7,1,6,2,4,6,0
ESP-La Liga,2425,Valladolid,André Ferreira,POR,GK,28-360,1996,6.0,0,0,0,0,0,0,0,,0,0,0,0,0,0,4,2
ESP-La Liga,2425,Valladolid,Antonio Candela,ITA,DF,25-027,2000,9.6,9,6,6,2,1,4,9,44.4,5,11,6,5,6,15,32,0
ESP-La Liga,2425,Valladolid,Anuar,MAR,"MF,FW",30-129,1995,18.6,36,25,20,11,5,13,26,50.0,13,23,8,15,18,54,26,1
ESP-La Liga,2425,Valladolid,Arnau Rafús,ESP,GK,22-027,2003,1.0,0,0,0,0,0,0,0,,0,0,0,0,0,0,0,1
ESP-La Liga,2425,Valladolid,Cenk Özkacar,TUR,DF,24-230,2000,7.9,9,5,7,2,0,4,13,30.8,9,9,6,3,18,27,68,1
ESP-La Liga,2425,Valladolid,Chuky san jose,ESP,MF,21-025,2004,8.1,8,2,3,3,2,2,9,22.2,7,4,1,3,0,8,4,0
ESP-La Liga,2425,Valladolid,Darwin Machís,VEN,"MF,FW",32-106,1993,7.1,5,4,3,2,0,3,9,33.3,6,3,0,3,5,10,13,0
ESP-La Liga,2425,Valladolid,David Torres,ESP,DF,22-080,2003,15.4,13,8,12,1,0,7,11,63.6,4,19,17,2,10,23,74,0
ESP-La Liga,2425,Valladolid,Enzo Boyomo,CMR,DF,23-229,2001,3.0,6,2,4,2,0,3,3,100.0,0,4,3,1,1,7,7,0
ESP-La Liga,2425,Valladolid,Eray Cömert,SUI,"DF,MF",27-109,1998,18.8,21,12,13,8,0,11,19,57.9,8,27,15,12,21,42,67,2
ESP-La Liga,2425,Valladolid,Florian Grillitsch,AUT,MF,29-290,1995,6.9,11,7,7,3,1,7,15,46.7,8,12,2,10,4,15,5,1
ESP-La Liga,2425,Valladolid,Henrique,BRA,DF,31-029,1994,2.9,3,2,2,1,0,0,3,0.0,3,5,0,5,2,5,10,0
ESP-La Liga,2425,Valladolid,Iago Parente,ESP,DF,19-088,2006,0.8,0,0,0,0,0,0,0,,0,0,0,0,0,0,2,0
ESP-La Liga,2425,Valladolid,Ibrahim Alani,NGA,MF,18-299,2006,0.8,6,4,2,4,0,2,2,100.0,0,1,0,1,1,7,1,0
ESP-La Liga,2425,Valladolid,Iván Sánchez,ESP,"MF,FW",32-243,1992,15.6,37,20,18,10,9,12,27,44.4,15,18,3,15,14,51,10,0
ESP-La Liga,2425,Valladolid,Javi Sánchez,ESP,DF,28-071,1997,22.5,26,16,19,6,1,17,26,65.4,9,39,28,11,22,48,111,3
ESP-La Liga,2425,Valladolid,Joseph Aidoo,GHA,DF,29-237,1995,6.0,5,5,3,2,0,2,3,66.7,1,6,3,3,4,9,22,1
ESP-La Liga,2425,Valladolid,Juanmi Latasa,ESP,FW,24-062,2001,14.7,4,2,1,1,2,2,6,33.3,4,4,1,3,0,4,11,1
ESP-La Liga,2425,Valladolid,Juma Bah,SLE,DF,19-043,2006,9.6,10,7,7,3,0,3,5,60.0,2,15,8,7,12,22,60,0
ESP-La Liga,2425,Valladolid,Karl Jakob Hein,EST,GK,23-041,2002,30.0,0,0,0,0,0,0,2,0.0,2,0,0,0,0,0,18,1
ESP-La Liga,2425,Valladolid,Kenedy,BRA,"MF,FW",29-105,1996,0.1,0,0,0,0,0,0,0,,0,1,0,1,0,0,0,0
ESP-La Liga,2425,Valladolid,Kike Pérez,ESP,MF,28-099,1997,13.2,37,26,15,19,3,15,26,57.7,11,16,4,12,7,44,18,0
ESP-La Liga,2425,Valladolid,Lucas Oliveira Rosa,BRA,DF,25-051,2000,21.0,53,33,40,11,2,35,51,68.6,16,24,9,15,28,81,69,2
ESP-La Liga,2425,Valladolid,Luis Pérez,ESP,DF,30-109,1995,27.9,38,27,23,10,5,24,40,60.0,16,26,9,17,28,66,85,0
ESP-La Liga,2425,Valladolid,Mamadou Sylla,SEN,"FW,MF",31-065,1994,16.8,6,3,2,2,2,2,8,25.0,6,7,0,7,3,9,12,1
ESP-La Liga,2425,Valladolid,Marcos André,BRA,FW,28-216,1996,13.2,10,6,3,5,2,5,13,38.5,8,18,2,16,3,13,10,0
ESP-La Liga,2425,Valladolid,Mario Maroto,ESP,MF,21-177,2003,0.2,0,0,0,0,0,0,1,0.0,1,0,0,0,2,2,1,0
ESP-La Liga,2425,Valladolid,Mario Martín,ESP,MF,21-080,2004,19.4,62,32,31,27,4,21,49,42.9,28,32,7,25,21,83,46,7
ESP-La Liga,2425,Valladolid,Raúl Chasco,ESP,DF,21-253,2003,1.4,4,1,3,1,0,2,4,50.0,2,1,0,1,2,6,2,0
ESP-La Liga,2425,Valladolid,Raúl Moro,ESP,"MF,FW",22-170,2002,25.0,22,13,15,4,3,13,31,41.9,18,7,0,7,10,32,17,1
ESP-La Liga,2425,Valladolid,Selim Amallah,MAR,MF,28-190,1996,15.3,30,18,10,18,2,10,18,55.6,8,24,2,22,14,44,5,1
ESP-La Liga,2425,Valladolid,Stanko Jurić,CRO,MF,28-281,1996,19.2,48,24,26,19,3,19,48,39.6,29,35,11,24,24,72,52,0
ESP-La Liga,2425,Valladolid,Tamás Nikitscher,HUN,"MF,DF",25-202,1999,8.5,16,7,8,8,0,7,11,63.6,4,15,3,12,10,26,15,1
ESP-La Liga,2425,Valladolid,Víctor Meseguer,ESP,MF,25-349,1999,4.6,10,6,4,4,2,2,10,20.0,8,3,0,3,2,12,4,1
ESP-La Liga,2425,Valladolid,Xavier Moreno,ESP,FW,20-200,2004,0.5,0,0,0,0,0,0,0,,0,0,0,0,0,0,1,0
ESP-La Liga,2425,Villarreal,Alex Baena,ESP,"MF,FW",23-308,2001,28.2,28,15,6,14,8,10,38,26.3,28,29,2,27,22,50,22,2
ESP-La Liga,2425,Villarreal,Alfonso Pedraza,ESP,"DF,MF",29-045,1996,4.1,3,2,2,0,1,2,4,50.0,2,2,1,1,5,8,13,0
ESP-La Liga,2425,Villarreal,Arnau Solà,ESP,MF,22-050,2003,0.1,0,0,0,0,0,0,2,0.0,2,1,1,0,0,0,0,0
ESP-La Liga,2425,Villarreal,Arnaut Danjuma,NED,FW,28-113,1997,2.2,2,1,0,1,1,0,1,0.0,1,1,0,1,0,2,0,0
ESP-La Liga,2425,Villarreal,Ayoze Pérez,ESP,FW,31-299,1993,21.9,27,14,5,18,4,6,24,25.0,18,17,0,17,8,35,15,0
ESP-La Liga,2425,Villarreal,Daniel Parejo,ESP,MF,36-038,1989,25.1,52,40,27,20,5,29,54,53.7,25,24,7,17,24,76,40,1
ESP-La Liga,2425,Villarreal,Denis Suárez,ESP,MF,31-138,1994,5.9,9,7,7,1,1,4,9,44.4,5,4,1,3,1,10,3,0
ESP-La Liga,2425,Villarreal,Diego Conde,ESP,GK,26-208,1998,20.8,2,2,2,0,0,2,4,50.0,2,0,0,0,1,3,9,2
ESP-La Liga,2425,Villarreal,Eric Bailly,CIV,DF,31-042,1994,6.9,12,4,6,6,0,3,4,75.0,1,12,6,6,6,18,29,0
ESP-La Liga,2425,Villarreal,Gerard Moreno,ESP,FW,33-047,1992,7.6,7,4,3,2,2,3,11,27.3,8,0,0,0,2,9,7,0
ESP-La Liga,2425,Villarreal,Ilias Akhomach,MAR,"MF,FW",21-038,2004,6.5,12,7,4,4,4,6,12,50.0,6,8,0,8,3,15,13,0
ESP-La Liga,2425,Villarreal,Juan Bernat,ESP,"DF,MF",32-084,1993,2.4,9,7,7,1,1,4,5,80.0,1,3,1,2,1,10,4,0
ESP-La Liga,2425,Villarreal,Juan Foyth,ARG,DF,27-132,1998,16.9,25,15,15,6,4,11,16,68.8,5,26,17,9,19,44,119,3
ESP-La Liga,2425,Villarreal,Karl Etta,CMR,"FW,MF",21-222,2003,0.2,0,0,0,0,0,0,1,0.0,1,1,0,1,0,0,0,0
ESP-La Liga,2425,Villarreal,Kiko Femenía,ESP,DF,34-111,1991,24.7,50,34,34,14,2,33,57,57.9,24,21,10,11,40,90,62,3
ESP-La Liga,2425,Villarreal,Logan Costa,CPV,DF,24-053,2001,27.7,38,21,25,12,1,24,29,82.8,5,22,13,9,21,59,111,2
ESP-La Liga,2425,Villarreal,Luiz Lúcio Reis Júnior,BRA,GK,24-130,2001,16.2,0,0,0,0,0,0,0,,0,0,0,0,0,0,14,1
ESP-La Liga,2425,Villarreal,Nicolas Pépé,CIV,"FW,MF",29-360,1995,16.3,22,9,12,6,4,6,17,35.3,11,12,1,11,5,27,12,0
ESP-La Liga,2425,Villarreal,Pape Gueye,SEN,MF,26-120,1999,23.9,54,26,23,23,8,20,28,71.4,8,31,13,18,27,81,51,2
ESP-La Liga,2425,Villarreal,Pau Cabanes,ESP,"MF,FW",20-096,2005,1.8,4,4,0,3,1,3,4,75.0,1,5,0,5,3,7,2,1
ESP-La Liga,2425,Villarreal,Pau Navarro,ESP,DF,20-029,2005,9.2,22,17,14,6,2,19,37,51.4,18,13,6,7,4,26,37,0
ESP-La Liga,2425,Villarreal,Ramón Terrats,ESP,"MF,FW",24-218,2000,1.5,3,3,1,2,0,2,4,50.0,2,3,1,2,2,5,3,0
ESP-La Liga,2425,Villarreal,Raúl Albiol,ESP,DF,39-262,1985,13.2,10,9,9,1,0,6,10,60.0,4,10,9,1,6,16,69,1
ESP-La Liga,2425,Villarreal,Santi Comesaña,ESP,MF,28-231,1996,28.4,85,49,44,32,9,42,76,55.3,34,56,22,34,19,104,56,1
ESP-La Liga,2425,Villarreal,Sergi Cardona,ESP,DF,25-320,1999,32.7,71,48,44,20,7,49,79,62.0,30,52,7,45,40,111,122,1
ESP-La Liga,2425,Villarreal,Tajon Buchanan,CAN,MF,26-105,1999,3.8,9,5,6,3,0,6,9,66.7,3,5,0,5,1,10,1,0
ESP-La Liga,2425,Villarreal,Thiago Ojeda,ARG,MF,22-132,2003,0.1,0,0,0,0,0,0,0,,0,0,0,0,0,0,1,0
ESP-La Liga,2425,Villarreal,Thierno Barry,FRA,FW,22-215,2002,24.8,11,8,2,5,4,4,10,40.0,6,15,2,13,0,11,18,0
ESP-La Liga,2425,Villarreal,Willy Kambwala,FRA,DF,20-272,2004,11.4,17,12,14,2,1,10,12,83.3,2,8,6,2,9,26,53,1
ESP-La Liga,2425,Villarreal,Yeremi Pino,ESP,"MF,FW",22-216,2002,20.9,56,29,19,29,8,29,62,46.8,33,36,3,33,8,64,18,0
FRA-Ligue 1,2425,Angers,Abdoulaye Bamba,CIV,DF,35-029,1990,16.8,22,12,17,4,1,14,19,73.7,5,14,8,6,19,41,79,0
FRA-Ligue 1,2425,Angers,Bamba Dieng,SEN,FW,25-062,2000,5.9,4,1,1,2,1,0,2,0.0,2,2,0,2,0,4,3,0
FRA-Ligue 1,2425,Angers,Carlens Arcus,HAI,DF,28-330,1996,22.7,52,35,32,15,5,34,56,60.7,22,24,4,20,27,79,83,3
FRA-Ligue 1,2425,Angers,Cédric Hountondji,BEN,DF,31-125,1994,3.0,6,4,4,2,0,3,7,42.9,4,3,3,0,4,10,14,0
FRA-Ligue 1,2425,Angers,Emmanuel Biumla,FRA,DF,20-016,2005,14.8,19,12,14,5,0,12,18,66.7,6,18,8,10,8,27,84,1
FRA-Ligue 1,2425,Angers,Enzo Caumont,FRA,MF,21-072,2004,0.4,1,1,0,1,0,1,2,50.0,1,1,1,0,1,2,1,0
FRA-Ligue 1,2425,Angers,Esteban Lepaul,FRA,FW,25-036,2000,18.1,11,6,2,6,3,4,16,25.0,12,15,2,13,4,15,10,0
FRA-Ligue 1,2425,Angers,Farid El Melali,ALG,FW,28-019,1997,21.0,28,16,15,6,7,13,35,37.1,22,19,1,18,16,44,12,1
FRA-Ligue 1,2425,Angers,Florent Hanin,ALG,DF,35-109,1990,29.7,69,48,45,17,7,39,71,54.9,32,31,10,21,47,116,99,2
FRA-Ligue 1,2425,Angers,Haris Belkebla,ALG,MF,31-116,1994,19.9,56,38,38,15,3,26,45,57.8,19,30,9,21,35,91,46,1
FRA-Ligue 1,2425,Angers,Himad Abdelli,ALG,"MF,FW",25-188,1999,31.6,48,32,13,20,15,15,48,31.3,33,24,1,23,26,74,28,2
FRA-Ligue 1,2425,Angers,Ibrahima Niane,SEN,FW,26-074,1999,10.5,7,3,3,2,2,3,3,100.0,0,6,1,5,2,9,6,2
FRA-Ligue 1,2425,Angers,Jacques Ekomie,GAB,"DF,FW",21-278,2003,7.7,22,14,9,10,3,8,12,66.7,4,16,5,11,4,26,14,0
FRA-Ligue 1,2425,Angers,Jean-Eudes Aholou,CIV,MF,31-065,1994,21.8,56,36,26,20,10,22,48,45.8,26,34,14,20,33,89,32,0
FRA-Ligue 1,2425,Angers,Jim Allevinah,GAB,FW,30-086,1995,19.4,19,11,6,9,4,5,28,17.9,23,10,0,10,12,31,17,0
FRA-Ligue 1,2425,Angers,Jordan Lefort,FRA,DF,31-288,1993,34.0,52,30,42,9,1,30,44,68.2,14,56,37,19,32,84,206,3
FRA-Ligue 1,2425,Angers,Justin-Noël Kalumba,FRA,"FW,MF",20-150,2004,0.3,0,0,0,0,0,0,0,,0,0,0,0,1,1,1,0
FRA-Ligue 1,2425,Angers,Lanroy Machine,FRA,FW,19-223,2005,0.1,0,0,0,0,0,0,0,,0,0,0,0,0,0,0,0
FRA-Ligue 1,2425,Angers,Lilian Raolisoa,FRA,"DF,FW",24-342,2000,14.6,41,24,24,13,4,17,38,44.7,21,11,2,9,15,56,45,0
FRA-Ligue 1,2425,Angers,Lois Diony,FRA,FW,32-155,1992,0.2,0,0,0,0,0,0,0,,0,0,0,0,0,0,0,0
FRA-Ligue 1,2425,Angers,Marius Courcoul,FRA,"MF,DF",18-143,2007,3.4,5,2,3,2,0,2,5,40.0,3,4,0,4,5,10,9,0
FRA-Ligue 1,2425,Angers,Melvin Zinga,FRA,GK,23-069,2002,1.0,0,0,0,0,0,0,0,,0,0,0,0,0,0,1,0
FRA-Ligue 1,2425,Angers,Ousmane Camara,FRA,DF,22-079,2003,2.8,4,3,3,1,0,1,2,50.0,1,1,1,0,0,4,18,0
FRA-Ligue 1,2425,Angers,Pierrick Capelle,FRA,MF,38-039,1987,5.4,24,17,10,9,5,9,18,50.0,9,4,1,3,11,35,5,1
FRA-Ligue 1,2425,Angers,Prosper Peter,NGA,"MF,FW",17-288,2007,0.3,2,1,0,2,0,0,0,,0,0,0,0,0,2,0,0
FRA-Ligue 1,2425,Angers,Sidiki Cherif,FRA,FW,18-160,2006,3.6,5,5,1,3,1,3,4,75.0,1,4,1,3,0,5,0,1
FRA-Ligue 1,2425,Angers,Yahia Fofana,CIV,GK,24-276,2000,33.0,0,0,0,0,0,0,2,0.0,2,0,0,0,1,1,25,2
FRA-Ligue 1,2425,Angers,Yassin Belkhdim,FRA,MF,23-099,2002,16.9,53,27,26,21,6,27,58,46.6,31,23,6,17,21,74,41,1
FRA-Ligue 1,2425,Angers,Zinedine Ferhat,ALG,"FW,MF",32-084,1993,9.4,9,7,1,5,3,4,13,30.8,9,9,0,9,10,19,12,0
FRA-Ligue 1,2425,Angers,Zinédine Ould Khaled,FRA,MF,25-130,2000,3.8,9,7,5,3,1,2,13,15.4,11,6,1,5,2,11,12,0
FRA-Ligue 1,2425,Auxerre,Ado Onaiwu,JPN,"MF,FW",29-197,1995,10.6,11,7,2,6,3,4,14,28.6,10,12,0,12,3,14,12,0
FRA-Ligue 1,2425,Auxerre,Aristide Zossou,CIV,MF,19-344,2005,0.2,0,0,0,0,0,0,0,,0,0,0,0,0,0,0,0
FRA-Ligue 1,2425,Auxerre,Assane Dioussé,SEN,MF,27-246,1997,7.4,15,7,9,5,1,5,14,35.7,9,6,2,4,12,27,15,0
FRA-Ligue 1,2425,Auxerre,Ben Viadere,FRA,MF,19-264,2005,0.1,0,0,0,0,0,0,0,,0,0,0,0,0,0,0,0
FRA-Ligue 1,2425,Auxerre,Clément Akpa,CIV,DF,23-181,2001,27.6,55,34,36,12,7,31,46,67.4,15,38,14,24,42,97,141,2
FRA-Ligue 1,2425,Auxerre,Donovan Léon,GUF,GK,32-202,1992,32.0,0,0,0,0,0,0,3,0.0,3,2,0,2,0,0,26,1
FRA-Ligue 1,2425,Auxerre,Elisha Owusu,GHA,MF,27-198,1997,26.0,73,41,29,39,5,31,48,64.6,17,33,9,24,42,115,35,1
FRA-Ligue 1,2425,Auxerre,Eros Maddy,NED,DF,24-108,2001,0.2,0,0,0,0,0,0,0,,0,0,0,0,0,0,0,0
FRA-Ligue 1,2425,Auxerre,Florian Ayé,FRA,FW,28-125,1997,6.4,2,2,0,0,2,0,2,0.0,2,7,0,7,7,9,6,0
FRA-Ligue 1,2425,Auxerre,Fredrik Oppegard,NOR,DF,22-290,2002,3.0,6,4,4,1,1,3,7,42.9,4,2,1,1,2,8,12,1
FRA-Ligue 1,2425,Auxerre,Gabriel Osho,NGA,DF,26-283,1998,18.4,23,15,17,3,3,13,20,65.0,7,32,19,13,12,35,87,0
FRA-Ligue 1,2425,Auxerre,Gaëtan Perrin,FRA,"MF,FW",28-351,1996,29.9,49,26,22,12,15,21,48,43.8,27,10,0,10,12,61,4,1
FRA-Ligue 1,2425,Auxerre,Gideon Mensah,GHA,DF,26-310,1998,25.3,68,45,37,21,10,33,66,50.0,33,27,4,23,50,118,83,0
FRA-Ligue 1,2425,Auxerre,Hamed Junior Traorè,CIV,MF,25-097,2000,23.3,41,20,11,17,13,16,54,29.6,38,14,0,14,8,49,11,0
FRA-Ligue 1,2425,Auxerre,Han-Noah Massengo,FRA,MF,23-321,2001,11.6,17,11,5,8,4,8,12,66.7,4,12,4,8,17,34,10,2
FRA-Ligue 1,2425,Auxerre,Jubal,BRA,DF,31-268,1993,29.3,60,39,46,13,1,28,40,70.0,12,61,36,25,25,85,201,1
FRA-Ligue 1,2425,Auxerre,Ki-Jana Hoever,NED,DF,23-126,2002,23.6,51,38,26,16,9,30,54,55.6,24,33,3,30,21,72,70,1
FRA-Ligue 1,2425,Auxerre,Kévin Danois,FRA,MF,20-330,2004,16.2,49,30,20,22,7,20,46,43.5,26,17,3,14,20,69,20,0
FRA-Ligue 1,2425,Auxerre,Lassine Sinayoko,MLI,"FW,MF",25-167,1999,25.5,33,20,10,14,9,11,23,47.8,12,16,2,14,13,46,38,0
FRA-Ligue 1,2425,Auxerre,Lasso Coulibaly,CIV,"FW,MF",22-217,2002,0.5,1,1,0,0,1,0,0,,0,0,0,0,0,1,0,0
FRA-Ligue 1,2425,Auxerre,Loïc N'Gatta,FRA,DF,21-164,2003,0.1,1,1,0,1,0,1,2,50.0,1,1,0,1,0,1,1,0
FRA-Ligue 1,2425,Auxerre,Paul Joly,FRA,DF,24-351,2000,11.2,49,32,30,17,2,27,45,60.0,18,19,1,18,25,74,32,5
FRA-Ligue 1,2425,Auxerre,Rayan Raveloson,MAD,"MF,DF",28-128,1997,8.0,6,5,2,4,0,5,15,33.3,10,8,7,1,5,11,22,0
FRA-Ligue 1,2425,Auxerre,Rudy Matondo,FRA,MF,17-072,2008,0.7,1,1,1,0,0,0,1,0.0,1,0,0,0,0,1,2,0
FRA-Ligue 1,2425,Auxerre,Sinaly Diomande,CIV,DF,24-045,2001,21.6,39,19,20,18,1,28,40,70.0,12,37,18,19,30,69,100,2
FRA-Ligue 1,2425,Auxerre,Theo Bair,CAN,FW,25-270,1999,10.4,4,3,1,2,1,0,2,0.0,2,6,2,4,3,7,10,0
FRA-Ligue 1,2425,Auxerre,Théo De Percin,MTQ,GK,24-111,2001,2.0,0,0,0,0,0,0,1,0.0,1,0,0,0,0,0,3,0
FRA-Ligue 1,2425,Auxerre,Théo Pellenard,FRA,DF,31-081,1994,0.5,3,2,2,1,0,1,3,33.3,2,1,0,1,0,3,3,0
FRA-Ligue 1,2425,Auxerre,Yoann Cissé,FRA,MF,20-162,2004,0.1,0,0,0,0,0,0,0,,0,0,0,0,1,1,0,0
FRA-Ligue 1,2425,Brest,Abdallah Sima,SEN,"FW,MF",23-341,2001,13.8,15,11,2,5,8,4,11,36.4,7,9,1,8,1,16,9,0
FRA-Ligue 1,2425,Brest,Abdoulaye Niakhate Ndiaye,SEN,DF,23-044,2002,19.0,49,33,36,12,1,25,37,67.6,12,29,17,12,11,60,144,3
FRA-Ligue 1,2425,Brest,Axel Camblan,FRA,"MF,FW",21-267,2003,0.3,1,1,0,0,1,1,2,50.0,1,1,0,1,0,1,0,0
FRA-Ligue 1,2425,Brest,Bradley Locko,FRA,DF,23-018,2002,1.1,2,2,1,1,0,1,1,100.0,0,3,2,1,1,3,3,0
FRA-Ligue 1,2425,Brest,Brendan Chardonnet,FRA,DF,30-153,1994,26.8,45,33,28,14,3,25,40,62.5,15,45,28,17,29,74,169,2
FRA-Ligue 1,2425,Brest,Edimilson Fernandes,SUI,"MF,DF",29-039,1996,12.3,9,7,3,6,0,7,13,53.8,6,14,6,8,20,29,38,1
FRA-Ligue 1,2425,Brest,Grégoire Coudert,FRA,GK,26-051,1999,2.0,0,0,0,0,0,0,0,,0,0,0,0,0,0,1,0
FRA-Ligue 1,2425,Brest,Hamidou Makalou,MLI,"FW,MF",18-313,2006,0.4,0,0,0,0,0,0,0,,0,0,0,0,0,0,0,0
FRA-Ligue 1,2425,Brest,Hianga Mananga Mbock,FRA,MF,25-147,1999,0.2,0,0,0,0,0,0,0,,0,0,0,0,1,1,0,0
FRA-Ligue 1,2425,Brest,Hugo Magnetti,FRA,MF,26-359,1998,25.8,52,32,21,27,4,23,51,45.1,28,20,3,17,18,70,37,0
FRA-Ligue 1,2425,Brest,Ibrahim Salah,MAR,FW,23-267,2001,4.0,4,2,1,1,2,1,6,16.7,5,2,0,2,2,6,0,0
FRA-Ligue 1,2425,Brest,Jonas Martin,FRA,MF,35-045,1990,5.5,13,7,10,2,1,6,11,54.5,5,4,1,3,8,21,12,1
FRA-Ligue 1,2425,Brest,Jordan Amavi,FRA,DF,31-076,1994,8.8,24,17,10,11,3,15,21,71.4,6,10,2,8,7,31,18,0
FRA-Ligue 1,2425,Brest,Julien Le Cardinal,FRA,DF,27-294,1997,15.3,27,15,16,8,3,11,16,68.8,5,18,14,4,33,60,75,0
FRA-Ligue 1,2425,Brest,Justin Bourgault,FRA,DF,19-252,2005,1.4,2,1,1,1,0,0,0,,0,0,0,0,0,2,1,0
FRA-Ligue 1,2425,Brest,Jérémy Le Douaron,FRA,FW,27-033,1998,1.1,1,0,0,0,1,0,1,0.0,1,1,0,1,0,1,0,0
FRA-Ligue 1,2425,Brest,Kamory Doumbia,MLI,"MF,FW",22-095,2003,14.7,41,29,17,17,7,14,31,45.2,17,17,1,16,28,69,13,1
FRA-Ligue 1,2425,Brest,Kenny Lala,MAD,DF,33-233,1991,29.8,66,42,36,23,7,38,57,66.7,19,25,9,16,25,91,75,2
FRA-Ligue 1,2425,Brest,Luc Zogbé,CIV,DF,20-061,2005,7.1,32,18,17,11,4,18,26,69.2,8,11,2,9,14,46,22,1
FRA-Ligue 1,2425,Brest,Ludovic Ajorque,FRA,FW,31-088,1994,27.7,26,19,3,12,11,10,32,31.3,22,20,5,15,6,32,26,0
FRA-Ligue 1,2425,Brest,Mahdi Camara,FRA,"MF,FW",26-328,1998,29.5,71,40,16,38,17,24,46,52.2,22,40,5,35,33,104,29,0
FRA-Ligue 1,2425,Brest,Mama Samba Baldé,GNB,FW,29-199,1995,12.8,13,9,4,4,5,3,14,21.4,11,8,0,8,6,19,14,0
FRA-Ligue 1,2425,Brest,Marco Bizot,NED,GK,34-075,1991,32.0,2,1,2,0,0,1,2,50.0,1,0,0,0,0,2,33,0
FRA-Ligue 1,2425,Brest,Massadio Haïdara,MLI,DF,32-173,1992,18.6,27,16,16,9,2,13,29,44.8,16,18,2,16,26,53,73,0
FRA-Ligue 1,2425,Brest,Mathias Pereira Lage,POR,"FW,MF",28-175,1996,17.5,37,24,16,13,8,18,39,46.2,21,17,2,15,20,57,20,2
FRA-Ligue 1,2425,Brest,Pierre Lees-Melou,FRA,MF,31-364,1993,17.0,48,33,20,19,9,25,54,46.3,29,19,3,16,12,60,23,0
FRA-Ligue 1,2425,Brest,Romain Del Castillo,FRA,FW,29-056,1996,14.0,31,22,9,13,9,19,32,59.4,13,16,0,16,6,37,5,0
FRA-Ligue 1,2425,Brest,Romain Faivre,FRA,"MF,FW",26-314,1998,10.0,13,10,4,5,4,5,10,50.0,5,8,0,8,4,17,3,1
FRA-Ligue 1,2425,Brest,Soumaïla Coulibaly,FRA,DF,21-222,2003,4.9,4,2,2,2,0,1,1,100.0,0,7,2,5,5,9,26,0
FRA-Ligue 1,2425,Brest,Sérigné Diop,SEN,FW,20-012,2005,0.0,1,0,0,1,0,0,0,,0,1,0,1,0,1,0,0
FRA-Ligue 1,2425,Le Havre,Abdoulaye Touré,GUI,MF,31-082,1994,25.8,61,34,31,21,9,33,59,55.9,26,36,19,17,34,95,42,5
FRA-Ligue 1,2425,Le Havre,Alois Confais,FRA,MF,28-259,1996,0.0,0,0,0,0,0,0,0,,0,0,0,0,0,0,0,0
FRA-Ligue 1,2425,Le Havre,André Ayew,GHA,FW,35-158,1989,16.1,18,10,3,7,8,7,13,53.8,6,9,2,7,3,21,21,1
FRA-Ligue 1,2425,Le Havre,Antoine Joujou,FRA,"MF,FW",22-073,2003,10.5,16,11,10,4,2,9,15,60.0,6,15,3,12,9,25,19,0
FRA-Ligue 1,2425,Le Havre,Arouna Sangante,SEN,DF,23-042,2002,13.8,25,16,11,14,0,10,17,58.8,7,11,5,6,21,46,65,3
FRA-Ligue 1,2425,Le Havre,Arthur Desmas,FRA,GK,31-047,1994,18.0,0,0,0,0,0,0,1,0.0,1,0,0,0,0,0,9,1
FRA-Ligue 1,2425,Le Havre,Christopher Operi,CIV,"DF,FW",28-025,1997,13.0,13,9,6,2,5,7,12,58.3,5,20,6,14,14,27,30,0
FRA-Ligue 1,2425,Le Havre,Daler Kuzyaev,RUS,MF,32-129,1993,6.3,13,8,7,4,2,2,9,22.2,7,7,4,3,9,22,8,0
FRA-Ligue 1,2425,Le Havre,Elysée Logbo,FRA,FW,21-018,2004,0.3,0,0,0,0,0,0,0,,0,0,0,0,0,0,0,0
FRA-Ligue 1,2425,Le Havre,Emmanuel Sabbi,USA,"FW,MF",27-151,1997,7.3,14,7,7,4,3,5,8,62.5,3,2,0,2,3,17,4,0
FRA-Ligue 1,2425,Le Havre,Etienne Youte Kinkoue,FRA,DF,23-130,2002,25.8,19,10,11,7,1,13,20,65.0,7,36,23,13,29,48,158,3
FRA-Ligue 1,2425,Le Havre,Fodé Ballo-Touré,SEN,"DF,MF",28-141,1997,6.5,8,7,3,4,1,5,9,55.6,4,8,3,5,4,12,27,0
FRA-Ligue 1,2425,Le Havre,Gautier Lloris,FRA,DF,29-310,1995,30.8,68,43,52,16,0,38,53,71.7,15,33,21,12,34,102,192,0
FRA-Ligue 1,2425,Le Havre,Ilyes Housni,FRA,"FW,MF",20-010,2005,2.6,7,5,2,3,2,2,4,50.0,2,2,0,2,1,8,2,0
FRA-Ligue 1,2425,Le Havre,Issa Soumaré,SEN,"FW,MF",24-226,2000,21.1,25,14,8,10,7,13,49,26.5,36,19,4,15,16,41,32,0
FRA-Ligue 1,2425,Le Havre,Josué Casimir,FRA,"FW,MF",23-242,2001,22.2,37,26,15,15,7,9,18,50.0,9,19,0,19,7,44,35,1
FRA-Ligue 1,2425,Le Havre,Junior Mwanga,FRA,MF,22-013,2003,10.6,26,16,10,13,3,11,19,57.9,8,10,3,7,8,34,18,2
FRA-Ligue 1,2425,Le Havre,Kandet Diawara,GUI,FW,25-103,2000,0.0,0,0,0,0,0,0,0,,0,1,0,1,0,0,1,0
FRA-Ligue 1,2425,Le Havre,Koka,EGY,FW,32-080,1993,9.5,4,1,1,3,0,0,4,0.0,4,3,0,3,4,8,6,1
FRA-Ligue 1,2425,Le Havre,Loïc Nego,HUN,"DF,FW",34-129,1991,27.3,58,35,37,16,5,41,64,64.1,23,17,3,14,29,87,82,0
FRA-Ligue 1,2425,Le Havre,Mahamadou Diawara,FRA,MF,20-096,2005,6.5,20,12,10,8,2,8,13,61.5,5,13,6,7,13,33,11,1
FRA-Ligue 1,2425,Le Havre,Mathieu Gorgelin,FRA,GK,34-292,1990,16.0,2,2,2,0,0,2,3,66.7,1,0,0,0,0,2,8,2
FRA-Ligue 1,2425,Le Havre,Mathéo Bodmer,FRA,MF,21-018,2004,0.1,0,0,0,0,0,0,0,,0,0,0,0,0,0,1,0
FRA-Ligue 1,2425,Le Havre,Oussama Targhalline,MAR,MF,23-004,2002,11.0,19,14,12,3,4,5,12,41.7,7,14,7,7,19,38,14,2
FRA-Ligue 1,2425,Le Havre,Rassoul Ndiaye,SEN,MF,23-164,2001,11.8,35,25,19,12,4,11,25,44.0,14,15,4,11,12,47,24,0
FRA-Ligue 1,2425,Le Havre,Samuel Grandsir,FRA,"MF,FW",28-283,1996,0.9,5,5,0,3,2,2,3,66.7,1,2,0,2,0,5,0,0
FRA-Ligue 1,2425,Le Havre,Steve Ngoura,FRA,FW,20-091,2005,3.2,4,2,1,1,2,3,3,100.0,0,2,1,1,0,4,2,0
FRA-Ligue 1,2425,Le Havre,Timothee Pembele,FRA,DF,22-257,2002,12.4,30,22,17,9,4,14,23,60.9,9,16,5,11,11,41,42,0
FRA-Ligue 1,2425,Le Havre,Yanis Zouaoui,ALG,"DF,FW",30-318,1994,10.8,20,10,10,8,2,11,15,73.3,4,15,2,13,8,28,43,0
FRA-Ligue 1,2425,Le Havre,Yassine Kechta,MAR,"MF,FW",23-088,2002,23.3,60,36,32,21,7,33,78,42.3,45,25,2,23,26,86,32,2
FRA-Ligue 1,2425,Le Havre,Yoann Salmier,GUF,DF,32-184,1992,8.9,14,7,9,4,1,10,13,76.9,3,12,8,4,10,24,59,0
FRA-Ligue 1,2425,Lens,Abdukodir Khusanov,UZB,DF,21-084,2004,10.8,15,11,9,5,1,7,11,63.6,4,17,11,6,26,41,57,0
FRA-Ligue 1,2425,Lens,Adrien Thomasson,FRA,MF,31-165,1993,29.1,90,47,42,25,23,52,95,54.7,43,48,3,45,19,109,28,2
FRA-Ligue 1,2425,Lens,Anass Zaroury,MAR,"FW,MF",24-198,2000,15.6,23,17,6,12,5,9,26,34.6,17,9,0,9,6,29,15,0
FRA-Ligue 1,2425,Lens,Andy Diouf,FRA,MF,22-007,2003,24.7,37,26,10,22,5,16,40,40.0,24,24,1,23,15,52,18,2
FRA-Ligue 1,2425,Lens,Angelo Fulgini,FRA,"MF,FW",28-277,1996,11.6,14,10,6,4,4,6,16,37.5,10,11,1,10,2,16,3,0
FRA-Ligue 1,2425,Lens,Brice Samba,FRA,GK,31-029,1994,15.0,0,0,0,0,0,0,0,,0,0,0,0,1,1,6,2
FRA-Ligue 1,2425,Lens,David Costa,POR,"MF,FW",24-139,2001,3.9,2,0,1,1,0,1,4,25.0,3,5,1,4,1,3,0,0
FRA-Ligue 1,2425,Lens,Deiver Machado,COL,"DF,MF",31-264,1993,20.1,36,26,14,14,8,17,30,56.7,13,20,4,16,16,52,34,2
FRA-Ligue 1,2425,Lens,Facundo Medina,ARG,DF,25-361,1999,28.3,44,29,22,18,4,24,42,57.1,18,30,10,20,32,76,70,0
FRA-Ligue 1,2425,Lens,Florian Sotoca,FRA,"FW,MF",34-211,1990,19.9,22,13,3,8,11,12,22,54.5,10,12,2,10,14,36,25,0
FRA-Ligue 1,2425,Lens,Gabin Capuano,FRA,FW,19-028,2006,0.1,0,0,0,0,0,0,0,,0,0,0,0,0,0,0,0
FRA-Ligue 1,2425,Lens,Goduine Koyalipou,CTA,FW,25-098,2000,9.8,3,2,0,3,0,1,1,100.0,0,4,0,4,1,4,8,0
FRA-Ligue 1,2425,Lens,Hamzat Ojediran,NGA,"MF,FW",21-191,2003,4.6,28,15,12,13,3,7,19,36.8,12,10,2,8,10,38,7,0
FRA-Ligue 1,2425,Lens,Hervé Koffi,BFA,GK,28-220,1996,5.0,1,1,1,0,0,1,1,100.0,0,0,0,0,0,1,5,0
FRA-Ligue 1,2425,Lens,Jeremy Agbonifo,SWE,"FW,MF",19-212,2005,3.3,7,6,6,0,1,3,7,42.9,4,2,1,1,1,8,0,1
FRA-Ligue 1,2425,Lens,Jhoanner Chávez,ECU,"DF,MF",23-029,2002,6.6,9,5,4,4,1,2,7,28.6,5,10,1,9,6,15,13,0
FRA-Ligue 1,2425,Lens,Jonathan Gradit,FRA,DF,32-181,1992,23.5,44,23,22,19,3,23,40,57.5,17,27,12,15,25,69,122,2
FRA-Ligue 1,2425,Lens,Juma Bah,SLE,DF,19-043,2006,7.6,16,10,6,10,0,5,7,71.4,2,10,7,3,17,33,47,1
FRA-Ligue 1,2425,Lens,Kembo Diliwidi,FRA,DF,19-110,2006,0.0,0,0,0,0,0,0,0,,0,0,0,0,0,0,0,0
FRA-Ligue 1,2425,Lens,Kevin Danso,AUT,DF,26-247,1998,12.0,19,7,12,5,2,12,16,75.0,4,25,19,6,20,39,62,1
FRA-Ligue 1,2425,Lens,Kyllian Antonio,FRA,"DF,MF",17-140,2008,1.5,3,2,2,0,1,1,3,33.3,2,3,0,3,3,6,3,1
FRA-Ligue 1,2425,Lens,M'Bala Nzola,ANG,FW,28-279,1996,16.2,5,4,0,1,4,3,9,33.3,6,9,1,8,5,10,7,0
FRA-Ligue 1,2425,Lens,Malang Sarr,FRA,DF,26-121,1999,15.4,21,13,12,6,3,16,27,59.3,11,18,9,9,22,43,63,3
FRA-Ligue 1,2425,Lens,Martin Satriano,URU,"FW,DF",24-093,2001,1.0,3,1,1,1,1,3,3,100.0,0,0,0,0,0,3,2,0
FRA-Ligue 1,2425,Lens,Mathew Ryan,AUS,GK,33-046,1992,14.0,1,0,1,0,0,1,2,50.0,1,0,0,0,1,2,2,2
FRA-Ligue 1,2425,Lens,Nampalys Mendy,SEN,MF,32-335,1992,6.5,15,8,4,7,4,6,14,42.9,8,8,2,6,9,24,8,0
FRA-Ligue 1,2425,Lens,Neil El Aynaoui,FRA,MF,23-326,2001,17.6,39,21,18,15,6,12,34,35.3,22,34,8,26,30,69,29,0
FRA-Ligue 1,2425,Lens,Przemysław Frankowski,POL,DF,30-042,1995,15.4,32,21,17,10,5,19,30,63.3,11,10,2,8,19,51,28,0
FRA-Ligue 1,2425,Lens,Rayan Fofana,FRA,"FW,MF",19-101,2006,0.3,2,2,1,1,0,0,0,,0,0,0,0,0,2,0,0
FRA-Ligue 1,2425,Lens,Ruben Aguilar,FRA,"DF,MF",32-028,1993,12.5,34,18,17,12,5,24,39,61.5,15,25,3,22,13,47,23,0
FRA-Ligue 1,2425,Lens,Rémy Labeau Lascary,GLP,"FW,MF",22-082,2003,7.1,16,10,7,6,3,5,11,45.5,6,5,0,5,1,17,7,0
FRA-Ligue 1,2425,Lens,Tom Pouilly,FRA,"DF,MF",21-340,2003,3.0,9,6,5,1,3,5,10,50.0,5,5,1,4,4,13,11,0
FRA-Ligue 1,2425,Lens,Wesley Saïd,FRA,FW,30-035,1995,10.1,16,11,3,10,3,6,13,46.2,7,6,0,6,2,18,2,0
FRA-Ligue 1,2425,Lille,Aaron Malouda,FRA,FW,19-175,2005,0.0,0,0,0,0,0,0,0,,0,0,0,0,0,0,0,0
FRA-Ligue 1,2425,Lille,Alexsandro Ribeiro,BRA,DF,25-288,1999,30.0,32,19,18,13,1,20,30,66.7,10,23,13,10,27,59,143,3
FRA-Ligue 1,2425,Lille,André Gomes,POR,MF,31-298,1993,14.2,27,13,9,11,7,11,31,35.5,20,7,1,6,6,33,11,2
FRA-Ligue 1,2425,Lille,Angel Gomes,ENG,MF,24-266,2000,8.2,10,6,4,4,2,2,12,16.7,10,0,0,0,0,10,2,0
FRA-Ligue 1,2425,Lille,Ayyoub Bouaddi,FRA,MF,17-234,2007,12.8,50,31,21,21,8,19,32,59.4,13,12,3,9,10,60,12,1
FRA-Ligue 1,2425,Lille,Aïssa Mandi,ALG,DF,33-214,1991,19.3,31,17,12,15,4,16,22,72.7,6,23,11,12,15,46,54,0
FRA-Ligue 1,2425,Lille,Bafodé Diakité,FRA,DF,24-138,2001,30.7,31,18,17,11,3,18,26,69.2,8,30,17,13,27,58,99,5
FRA-Ligue 1,2425,Lille,Benjamin André,FRA,MF,34-294,1990,29.9,103,57,31,60,12,54,96,56.3,42,42,6,36,48,151,56,0
FRA-Ligue 1,2425,Lille,Chuba Akpom,ENG,FW,29-227,1995,7.1,8,5,0,4,4,2,6,33.3,4,9,0,9,0,8,3,0
FRA-Ligue 1,2425,Lille,Edon Zhegrova,KVX,"FW,MF",26-054,1999,10.9,5,2,3,0,2,2,7,28.6,5,8,0,8,4,9,1,0
FRA-Ligue 1,2425,Lille,Ethan Mbappé,FRA,"MF,FW",18-146,2006,2.5,6,2,3,2,1,0,4,0.0,4,6,0,6,1,7,0,0
FRA-Ligue 1,2425,Lille,Gabriel Gudmundsson,SWE,DF,26-025,1999,19.8,36,25,15,15,6,23,36,63.9,13,19,7,12,17,53,41,3
FRA-Ligue 1,2425,Lille,Hákon Arnar Haraldsson,ISL,"MF,FW",22-044,2003,19.5,36,16,9,17,10,16,33,48.5,17,10,2,8,8,44,6,0
FRA-Ligue 1,2425,Lille,Ismaily,BRA,DF,35-133,1990,10.0,33,17,17,12,4,17,26,65.4,9,15,1,14,13,46,49,0
FRA-Ligue 1,2425,Lille,Jonathan David,CAN,FW,25-130,2000,28.4,24,8,3,12,9,9,21,42.9,12,13,2,11,7,31,10,1
FRA-Ligue 1,2425,Lille,Lucas Chevalier,FRA,GK,23-199,2001,34.0,3,2,3,0,0,3,4,75.0,1,0,0,0,0,3,13,4
FRA-Ligue 1,2425,Lille,Matias Fernandez-Pardo,BEL,"FW,MF",20-110,2005,11.8,12,9,3,6,3,6,12,50.0,6,9,0,9,3,15,6,0
FRA-Ligue 1,2425,Lille,Mitchel Bakker,NED,"FW,DF",24-338,2000,12.7,23,13,6,11,6,10,19,52.6,9,10,1,9,12,35,15,0
FRA-Ligue 1,2425,Lille,Mohamed Lamine Bayo,GUI,FW,26-354,1998,3.4,1,1,0,0,1,1,1,100.0,0,0,0,0,0,1,4,0
FRA-Ligue 1,2425,Lille,Nabil Bentaleb,ALG,MF,30-181,1994,3.7,4,3,2,0,2,3,7,42.9,4,5,0,5,5,9,7,2
FRA-Ligue 1,2425,Lille,Ngal'Ayel Mukau,COD,MF,20-175,2004,13.2,33,18,9,22,2,17,29,58.6,12,14,0,14,15,48,22,0
FRA-Ligue 1,2425,Lille,Osame Sahraoui,MAR,"FW,MF",23-347,2001,14.4,13,9,4,4,5,3,8,37.5,5,14,1,13,7,20,8,1
FRA-Ligue 1,2425,Lille,Ousmane Toure,FRA,DF,20-095,2005,0.1,0,0,0,0,0,0,0,,0,0,0,0,1,1,2,0
FRA-Ligue 1,2425,Lille,Rémy Cabella,FRA,"FW,MF",35-077,1990,11.2,39,19,16,13,10,19,33,57.6,14,10,1,9,8,47,5,0
FRA-Ligue 1,2425,Lille,Thomas Meunier,BEL,DF,33-254,1991,21.4,53,38,32,15,6,33,49,67.3,16,21,8,13,34,87,64,0
FRA-Ligue 1,2425,Lille,Tiago Santos,POR,DF,22-305,2002,4.5,12,7,4,5,3,6,9,66.7,3,2,0,2,2,14,4,0
FRA-Ligue 1,2425,Lille,Younes Lachaab,FRA,"MF,FW",20-138,2005,0.1,1,1,0,0,1,1,1,100.0,0,0,0,0,1,2,0,0
FRA-Ligue 1,2425,Lyon,Abner,BRA,DF,24-362,2000,12.1,29,20,12,10,7,21,32,65.6,11,15,2,13,5,34,41,0
FRA-Ligue 1,2425,Lyon,Adryelson,BRA,DF,27-062,1998,0.0,0,0,0,0,0,0,0,,0,0,0,0,1,1,1,0
FRA-Ligue 1,2425,Lyon,Ainsley Maitland-Niles,ENG,DF,27-268,1997,22.1,71,44,30,26,15,48,76,63.2,28,28,4,24,25,96,61,6
FRA-Ligue 1,2425,Lyon,Alejandro Rodriguez,POR,MF,17-075,2008,0.2,0,0,0,0,0,0,0,,0,0,0,0,0,0,0,0
FRA-Ligue 1,2425,Lyon,Alexandre Lacazette,FRA,FW,33-361,1991,22.8,13,6,3,7,3,5,16,31.3,11,13,3,10,8,21,7,0
FRA-Ligue 1,2425,Lyon,Clinton Mata,ANG,DF,32-198,1992,26.3,41,29,23,14,4,28,36,77.8,8,26,17,9,46,87,72,3
FRA-Ligue 1,2425,Lyon,Corentin Tolisso,FRA,MF,30-294,1994,25.9,57,25,21,26,10,34,65,52.3,31,52,13,39,22,79,41,1
FRA-Ligue 1,2425,Lyon,Duje Ćaleta-Car,CRO,DF,28-249,1996,17.6,20,12,11,9,0,10,19,52.6,9,33,25,8,17,37,97,2
FRA-Ligue 1,2425,Lyon,Ernest Nuamah,GHA,"FW,MF",21-204,2003,11.7,21,11,15,4,2,12,27,44.4,15,9,1,8,8,29,8,1
FRA-Ligue 1,2425,Lyon,Georges Mikautadze,GEO,FW,24-205,2000,16.1,7,6,1,3,3,3,9,33.3,6,11,0,11,4,11,6,0
FRA-Ligue 1,2425,Lyon,Gift Orban,NGA,"FW,DF",22-311,2002,2.1,0,0,0,0,0,0,1,0.0,1,0,0,0,0,0,0,0
FRA-Ligue 1,2425,Lyon,Jordan Veretout,FRA,MF,32-084,1993,17.3,30,14,14,14,2,17,40,42.5,23,17,3,14,5,35,23,1
FRA-Ligue 1,2425,Lyon,Lucas Perri,BRA,GK,27-165,1997,33.0,1,1,1,0,0,0,4,0.0,4,1,0,1,0,1,22,1
FRA-Ligue 1,2425,Lyon,Mahamadou Diawara,FRA,MF,20-096,2005,0.2,1,0,0,1,0,1,3,33.3,2,2,0,2,0,1,0,0
FRA-Ligue 1,2425,Lyon,Malick Fofana,BEL,FW,20-054,2005,17.7,22,11,8,11,3,8,17,47.1,9,12,0,12,8,30,6,0
FRA-Ligue 1,2425,Lyon,Mama Samba Baldé,GNB,FW,29-199,1995,0.4,2,2,0,2,0,0,0,,0,0,0,0,1,3,1,0
FRA-Ligue 1,2425,Lyon,Maxence Caqueret,FRA,MF,25-098,2000,6.4,21,11,5,11,5,4,22,18.2,18,12,2,10,7,28,2,0
FRA-Ligue 1,2425,Lyon,Moussa Niakhate,SEN,DF,29-077,1996,30.3,47,27,37,8,2,24,32,75.0,8,26,17,9,25,72,143,3
FRA-Ligue 1,2425,Lyon,Nemanja Matić,SRB,MF,36-296,1988,22.3,42,29,15,21,6,23,41,56.1,18,21,9,12,18,60,31,1
FRA-Ligue 1,2425,Lyon,Nicolás Tagliafico,ARG,DF,32-266,1992,21.1,57,37,24,22,11,29,48,60.4,19,25,7,18,36,93,55,0
FRA-Ligue 1,2425,Lyon,Orel Mangala,BEL,MF,27-067,1998,0.7,1,0,0,0,1,0,1,0.0,1,2,0,2,0,1,1,0
FRA-Ligue 1,2425,Lyon,Paul Akouokou,CIV,MF,27-155,1997,0.2,1,0,0,1,0,0,0,,0,0,0,0,1,2,0,1
FRA-Ligue 1,2425,Lyon,Rayan Cherki,FRA,"FW,MF",21-280,2003,22.7,15,12,3,8,4,6,28,21.4,22,6,0,6,7,22,6,0
FRA-Ligue 1,2425,Lyon,Rémy Descamps,FRA,GK,28-333,1996,1.0,0,0,0,0,0,0,0,,0,0,0,0,0,0,0,0
FRA-Ligue 1,2425,Lyon,Sael Kumbedi,FRA,DF,20-059,2005,10.6,28,14,11,13,4,14,20,70.0,6,11,3,8,8,36,32,1
FRA-Ligue 1,2425,Lyon,Saïd Benrahma,ALG,"FW,MF",29-287,1995,8.2,9,5,4,4,1,3,10,30.0,7,6,0,6,3,12,2,0
FRA-Ligue 1,2425,Lyon,Tanner Tessmann,USA,MF,23-242,2001,13.7,25,15,11,10,4,12,25,48.0,13,13,7,6,19,44,29,1
FRA-Ligue 1,2425,Lyon,Thiago Almada,ARG,"MF,FW",24-028,2001,10.6,14,8,7,5,2,7,21,33.3,14,2,0,2,7,21,6,3
FRA-Ligue 1,2425,Lyon,Téo Barisic,FRA,DF,20-236,2004,0.0,0,0,0,0,0,0,0,,0,0,0,0,0,0,1,0
FRA-Ligue 1,2425,Lyon,Warmed Omari,COM,DF,25-031,2000,0.1,0,0,0,0,0,0,0,,0,0,0,0,0,0,1,0
FRA-Ligue 1,2425,Lyon,Wilfried Zaha,CIV,FW,32-195,1992,0.8,1,1,1,0,0,1,2,50.0,1,3,0,3,1,2,0,0
FRA-Ligue 1,2425,Marseille,Adrien Rabiot,FRA,MF,30-051,1995,27.6,49,31,17,21,11,19,32,59.4,13,21,2,19,21,70,32,0
FRA-Ligue 1,2425,Marseille,Amar Dedić,BIH,DF,22-279,2002,3.5,5,4,2,2,1,3,10,30.0,7,0,0,0,3,8,12,1
FRA-Ligue 1,2425,Marseille,Amine Gouiri,ALG,"FW,MF",25-097,2000,11.6,5,5,0,1,4,2,3,66.7,1,9,0,9,1,6,1,0
FRA-Ligue 1,2425,Marseille,Amine Harit,MAR,MF,27-340,1997,5.8,8,7,0,6,2,1,2,50.0,1,6,0,6,3,11,1,1
FRA-Ligue 1,2425,Marseille,Bamo Meïté,CIV,DF,23-172,2001,0.3,0,0,0,0,0,0,0,,0,0,0,0,0,0,1,0
FRA-Ligue 1,2425,Marseille,Bilal Nadir,MAR,MF,21-177,2003,4.3,10,3,4,6,0,4,6,66.7,2,6,1,5,4,14,7,0
FRA-Ligue 1,2425,Marseille,Darryl Bakola,FRA,"DF,MF",17-175,2007,0.2,1,1,0,1,0,0,0,,0,0,0,0,0,1,0,0
FRA-Ligue 1,2425,Marseille,Derek Cornelius,CAN,DF,27-180,1997,15.8,24,17,15,8,1,17,22,77.3,5,16,10,6,14,38,51,0
FRA-Ligue 1,2425,Marseille,Elye Wahi,FRA,FW,22-142,2003,6.4,0,0,0,0,0,0,4,0.0,4,1,0,1,1,1,0,0
FRA-Ligue 1,2425,Marseille,Emmanuel Koum Mbondo,FRA,DF,19-108,2006,0.1,0,0,0,0,0,0,0,,0,0,0,0,0,0,0,0
FRA-Ligue 1,2425,Marseille,Enzo Sternal,FRA,"FW,MF",17-361,2007,0.3,0,0,0,0,0,0,0,,0,0,0,0,0,0,0,0
FRA-Ligue 1,2425,Marseille,Faris Pemi Moumbagna,CMR,FW,24-327,2000,0.1,0,0,0,0,0,0,0,,0,0,0,0,0,0,0,0
FRA-Ligue 1,2425,Marseille,Geoffrey Kondogbia,CTA,"DF,MF",32-098,1993,22.4,60,38,31,26,3,27,34,79.4,7,23,6,17,22,82,64,4
FRA-Ligue 1,2425,Marseille,Gerónimo Rulli,ARG,GK,33-004,1992,34.0,4,3,4,0,0,4,8,50.0,4,1,0,1,1,5,25,3
FRA-Ligue 1,2425,Marseille,Ismaël Bennacer,ALG,MF,27-174,1997,7.2,21,10,8,12,1,12,18,66.7,6,6,0,6,10,31,2,1
FRA-Ligue 1,2425,Marseille,Ismaël Koné,CAN,"MF,FW",22-352,2002,4.0,8,4,3,3,2,3,4,75.0,1,4,1,3,4,12,2,1
FRA-Ligue 1,2425,Marseille,Jon Rowe,ENG,"FW,MF",22-024,2003,9.0,15,11,5,4,6,6,14,42.9,8,4,1,3,2,17,4,0
FRA-Ligue 1,2425,Marseille,Keyliane Abdallah,FRA,FW,19-049,2006,0.0,1,1,1,0,0,1,1,100.0,0,0,0,0,0,1,0,0
FRA-Ligue 1,2425,Marseille,Leonardo Balerdi,ARG,DF,26-118,1999,25.3,54,39,32,17,5,27,47,57.4,20,25,14,11,38,92,72,4
FRA-Ligue 1,2425,Marseille,Lilian Brassier,FRA,DF,25-203,1999,8.7,8,6,8,0,0,5,6,83.3,1,8,3,5,9,17,28,2
FRA-Ligue 1,2425,Marseille,Luis Henrique,BRA,"DF,FW",23-161,2001,29.0,16,9,7,6,3,9,10,90.0,1,15,2,13,10,26,30,0
FRA-Ligue 1,2425,Marseille,Luiz Felipe,ITA,DF,28-063,1997,1.4,4,3,3,1,0,1,2,50.0,1,3,2,1,3,7,5,0
FRA-Ligue 1,2425,Marseille,Mason Greenwood,ENG,"FW,MF",23-235,2001,31.2,35,18,10,14,11,16,39,41.0,23,7,0,7,12,47,5,2
FRA-Ligue 1,2425,Marseille,Michael Amir Murillo,PAN,DF,29-102,1996,27.1,49,31,30,13,6,32,46,69.6,14,21,8,13,18,67,70,4
FRA-Ligue 1,2425,Marseille,Neal Maupay,FRA,FW,28-283,1996,11.6,9,4,1,6,2,3,6,50.0,3,5,0,5,2,11,0,0
FRA-Ligue 1,2425,Marseille,Pierre Højbjerg,DEN,MF,29-292,1995,29.6,64,45,25,32,7,37,69,53.6,32,28,4,24,42,106,33,2
FRA-Ligue 1,2425,Marseille,Pol Lirola,ESP,DF,27-284,1997,7.6,13,9,5,8,0,5,13,38.5,8,7,2,5,4,17,12,0
FRA-Ligue 1,2425,Marseille,Quentin Merlin,FRA,DF,23-008,2002,17.7,22,17,12,5,5,9,16,56.3,7,20,4,16,14,36,17,1
FRA-Ligue 1,2425,Marseille,Robinio Vaz,FRA,FW,18-096,2007,0.8,1,1,0,0,1,0,2,0.0,2,0,0,0,0,1,2,0
FRA-Ligue 1,2425,Marseille,Ulisses Garcia,SUI,DF,29-133,1996,10.3,14,11,7,5,2,4,14,28.6,10,5,1,4,8,22,18,0
FRA-Ligue 1,2425,Marseille,Valentin Carboni,ARG,"MF,FW",20-080,2005,1.1,2,2,0,1,1,0,1,0.0,1,1,0,1,1,3,1,0
FRA-Ligue 1,2425,Marseille,Valentin Rongier,FRA,"MF,DF",30-168,1994,17.4,50,28,14,31,5,27,43,62.8,16,30,9,21,33,83,28,5
FRA-Ligue 1,2425,Monaco,Aleksandr Golovin,RUS,"MF,FW",28-359,1996,12.8,38,24,9,20,9,17,39,43.6,22,16,4,12,12,50,7,0
FRA-Ligue 1,2425,Monaco,Almoatasem Al Musrati,LBY,MF,29-048,1996,4.3,14,11,5,8,1,7,11,63.6,4,3,1,2,5,19,9,0
FRA-Ligue 1,2425,Monaco,Breel Embolo,SUI,"FW,MF",28-099,1997,20.5,22,17,7,7,8,5,16,31.3,11,11,0,11,3,25,10,1
FRA-Ligue 1,2425,Monaco,Caio Henrique Oliveira Silva,BRA,DF,27-297,1997,21.4,37,26,16,19,2,23,44,52.3,21,26,8,18,22,59,59,0
FRA-Ligue 1,2425,Monaco,Christian Mawissa,FRA,DF,20-036,2005,16.7,42,29,27,13,2,26,44,59.1,18,25,6,19,26,68,48,1
FRA-Ligue 1,2425,Monaco,Denis Zakaria,SUI,MF,28-185,1996,23.8,41,26,15,19,7,24,33,72.7,9,31,8,23,34,75,39,1
FRA-Ligue 1,2425,Monaco,Eliesse Ben Seghir,MAR,"MF,FW",20-097,2005,19.4,31,22,12,12,7,18,32,56.3,14,20,0,20,13,44,4,0
FRA-Ligue 1,2425,Monaco,Eliot Matazo,BEL,MF,23-098,2002,0.8,3,2,0,3,0,0,0,,0,0,0,0,1,4,2,0
FRA-Ligue 1,2425,Monaco,Folarin Balogun,USA,FW,23-325,2001,6.8,1,1,0,0,1,0,4,0.0,4,0,0,0,1,2,0,0
FRA-Ligue 1,2425,Monaco,George Ilenikhena,FRA,FW,18-281,2006,8.0,4,2,0,3,1,1,2,50.0,1,0,0,0,2,6,0,0
FRA-Ligue 1,2425,Monaco,Ismail Jakobs,SEN,DF,25-280,1999,2.0,5,5,3,0,2,3,5,60.0,2,0,0,0,2,7,6,0
FRA-Ligue 1,2425,Monaco,Jordan Teze,NED,DF,25-236,1999,6.3,18,9,8,9,1,7,16,43.8,9,12,1,11,6,24,15,0
FRA-Ligue 1,2425,Monaco,Kassoum Ouattara,FRA,"DF,FW",20-222,2004,4.3,9,7,5,4,0,4,14,28.6,10,6,0,6,5,14,2,1
FRA-Ligue 1,2425,Monaco,Krépin Diatta,SEN,"DF,FW",26-088,1999,5.6,18,12,13,2,3,14,24,58.3,10,5,1,4,9,27,12,2
FRA-Ligue 1,2425,Monaco,Lamine Camara,SEN,MF,21-143,2004,22.8,66,41,22,34,10,26,48,54.2,22,30,4,26,31,97,32,1
FRA-Ligue 1,2425,Monaco,Lucas Michal,FRA,"FW,MF",19-337,2005,1.3,5,3,3,2,0,2,4,50.0,2,2,0,2,1,6,2,0
FRA-Ligue 1,2425,Monaco,Maghnes Akliouche,FRA,"FW,MF",23-088,2002,26.7,51,31,12,24,15,19,41,46.3,22,21,0,21,15,66,13,0
FRA-Ligue 1,2425,Monaco,Mamadou Coulibaly,FRA,MF,21-033,2004,0.1,1,0,0,1,0,0,0,,0,0,0,0,0,1,0,0
FRA-Ligue 1,2425,Monaco,Mika Biereth,DEN,FW,22-105,2003,13.6,5,5,0,3,2,3,7,42.9,4,11,0,11,4,9,7,0
FRA-Ligue 1,2425,Monaco,Mohammed Salisu,GHA,DF,26-037,1999,11.4,28,18,16,11,1,13,16,81.3,3,10,8,2,16,44,54,2
FRA-Ligue 1,2425,Monaco,Philipp Köhn,SUI,GK,27-052,1998,19.0,0,0,0,0,0,0,1,0.0,1,0,0,0,0,0,11,2
FRA-Ligue 1,2425,Monaco,Radosław Majecki,POL,GK,25-189,1999,15.0,0,0,0,0,0,0,2,0.0,2,0,0,0,0,0,8,1
FRA-Ligue 1,2425,Monaco,Saïmon Bouabré,FRA,"MF,FW",18-357,2006,1.1,1,0,0,1,0,0,3,0.0,3,1,0,1,0,1,0,0
FRA-Ligue 1,2425,Monaco,Soungoutou Magassa,FRA,MF,21-228,2003,11.4,47,25,14,27,6,25,46,54.3,21,16,3,13,21,68,19,1
FRA-Ligue 1,2425,Monaco,Takumi Minamino,JPN,"MF,FW",30-128,1995,24.8,33,19,7,14,12,15,42,35.7,27,26,1,25,10,43,20,0
FRA-Ligue 1,2425,Monaco,Thilo Kehrer,GER,DF,28-245,1996,26.5,37,23,26,11,0,22,38,57.9,16,18,10,8,36,73,113,1
FRA-Ligue 1,2425,Monaco,Vanderson,BRA,DF,23-337,2001,22.9,76,48,37,30,9,45,64,70.3,19,43,6,37,39,115,65,2
FRA-Ligue 1,2425,Monaco,Wilfried Singo,CIV,DF,24-150,2000,23.3,37,23,24,10,3,20,28,71.4,8,17,9,8,43,80,110,2
FRA-Ligue 1,2425,Montpellier,Akor Adams,NGA,FW,25-115,2000,11.9,4,3,1,2,1,3,4,75.0,1,2,1,1,1,5,5,1
FRA-Ligue 1,2425,Montpellier,Andy Delort,ALG,FW,33-227,1991,6.7,4,3,1,2,1,1,2,50.0,1,3,1,2,0,4,3,0
FRA-Ligue 1,2425,Montpellier,Arnaud Nordin,FRA,FW,26-341,1998,13.0,24,15,6,16,2,11,21,52.4,10,12,0,12,5,29,7,0
FRA-Ligue 1,2425,Montpellier,Axel Gueguin,FRA,FW,20-061,2005,0.3,1,1,0,1,0,1,1,100.0,0,0,0,0,0,1,0,0
FRA-Ligue 1,2425,Montpellier,Bamo Meïté,CIV,DF,23-172,2001,4.7,5,3,2,1,2,1,2,50.0,1,3,3,0,4,9,14,3
FRA-Ligue 1,2425,Montpellier,Becir Omeragic,SUI,DF,23-124,2002,20.0,32,16,19,12,1,16,21,76.2,5,32,21,11,13,45,78,0
FRA-Ligue 1,2425,Montpellier,Benjamin Lecomte,FRA,GK,34-028,1991,30.0,0,0,0,0,0,0,0,,0,0,0,0,0,0,18,2
FRA-Ligue 1,2425,Montpellier,Birama Touré,MLI,"MF,DF",32-352,1992,3.3,8,5,5,2,1,4,6,66.7,2,3,2,1,6,14,7,0
FRA-Ligue 1,2425,Montpellier,Boubakar Kouyaté,MLI,DF,28-039,1997,8.4,22,17,16,6,0,11,19,57.9,8,17,11,6,12,34,54,0
FRA-Ligue 1,2425,Montpellier,Dimitry Bertaud,COD,GK,26-352,1998,4.0,0,0,0,0,0,0,0,,0,0,0,0,0,0,2,0
FRA-Ligue 1,2425,Montpellier,Enzo Tchato,CMR,DF,22-182,2002,21.1,48,26,26,18,4,26,44,59.1,18,30,10,20,22,70,59,0
FRA-Ligue 1,2425,Montpellier,Falaye Sacko,MLI,DF,30-023,1995,13.7,14,8,9,4,1,9,19,47.4,10,17,7,10,13,27,21,0
FRA-Ligue 1,2425,Montpellier,Gabriel Bares,SUI,"MF,DF",24-268,2000,0.6,2,2,2,0,0,1,2,50.0,1,0,0,0,1,3,3,0
FRA-Ligue 1,2425,Montpellier,Issiaga Sylla,GUI,DF,31-143,1994,12.8,25,10,17,7,1,15,29,51.7,14,13,4,9,10,35,34,1
FRA-Ligue 1,2425,Montpellier,Jordan Ferri,FRA,MF,33-073,1992,19.7,42,23,18,22,2,18,44,40.9,26,20,3,17,9,51,20,0
FRA-Ligue 1,2425,Montpellier,Joris Chotard,FRA,MF,23-242,2001,21.0,39,27,17,20,2,20,46,43.5,26,28,10,18,19,58,52,1
FRA-Ligue 1,2425,Montpellier,Junior Ndiaye,FRA,FW,20-056,2005,4.9,3,2,2,1,0,1,4,25.0,3,2,1,1,0,3,2,0
FRA-Ligue 1,2425,Montpellier,Khalil Fayad,FRA,"MF,FW",20-349,2004,11.4,31,16,12,17,2,15,28,53.6,13,18,1,17,10,41,15,1
FRA-Ligue 1,2425,Montpellier,Lucas Mincarelli,FRA,DF,21-139,2004,7.9,17,10,6,9,2,6,13,46.2,7,8,5,3,9,26,27,0
FRA-Ligue 1,2425,Montpellier,Modibo Sagnan,MLI,DF,26-040,1999,23.8,57,35,38,16,3,26,44,59.1,18,24,13,11,29,86,110,5
FRA-Ligue 1,2425,Montpellier,Musa Al-Taamari,JOR,"FW,MF",27-348,1997,12.4,14,10,4,5,5,8,15,53.3,7,2,0,2,3,17,3,2
FRA-Ligue 1,2425,Montpellier,Nicolas Pays,FRA,"FW,MF",21-290,2003,5.0,13,6,3,4,6,4,8,50.0,4,1,0,1,4,17,2,0
FRA-Ligue 1,2425,Montpellier,Nikola Maksimović,SRB,DF,33-180,1991,6.5,9,5,6,3,0,6,7,85.7,1,5,4,1,6,15,30,1
FRA-Ligue 1,2425,Montpellier,Othmane Maamma,MAR,"FW,MF",19-230,2005,4.0,3,1,2,1,0,1,4,25.0,3,4,0,4,1,4,2,1
FRA-Ligue 1,2425,Montpellier,Rabby Nzingoula,CGO,MF,19-180,2005,18.8,64,42,26,31,7,27,58,46.6,31,27,5,22,29,93,23,0
FRA-Ligue 1,2425,Montpellier,Simon Cara,FRA,"MF,FW",19-358,2005,0.1,0,0,0,0,0,0,0,,0,0,0,0,0,0,0,0
FRA-Ligue 1,2425,Montpellier,Stefan Džodić,SRB,"DF,MF",20-070,2005,2.7,8,5,3,5,0,5,8,62.5,3,5,4,1,5,13,10,1
FRA-Ligue 1,2425,Montpellier,Tanguy Coulibaly,FRA,"FW,MF",24-095,2001,16.5,32,24,13,15,4,14,33,42.4,19,18,2,16,11,43,3,1
FRA-Ligue 1,2425,Montpellier,Théo Chennahi,FRA,DF,20-107,2005,2.0,6,3,3,3,0,4,7,57.1,3,3,0,3,2,8,6,0
FRA-Ligue 1,2425,Montpellier,Théo Sainte-Luce,FRA,DF,26-216,1998,11.3,24,11,16,4,4,16,33,48.5,17,16,4,12,12,36,33,1
FRA-Ligue 1,2425,Montpellier,Téji Savanier,FRA,MF,33-153,1991,26.3,29,25,7,16,6,18,43,41.9,25,16,1,15,15,44,21,4
FRA-Ligue 1,2425,Montpellier,Wahbi Khazri,TUN,"FW,MF",34-105,1991,12.4,25,18,5,16,4,8,21,38.1,13,13,1,12,5,30,7,0
FRA-Ligue 1,2425,Montpellier,Wilfried Ndollo,CMR,DF,19-315,2005,4.5,6,5,4,1,1,4,8,50.0,4,9,1,8,7,13,11,0
FRA-Ligue 1,2425,Montpellier,Yael Mouanga,FRA,DF,19-305,2005,10.5,14,8,9,3,2,7,9,77.8,2,16,8,8,10,24,50,0
FRA-Ligue 1,2425,Montpellier,Yanis Issoufou,FRA,"MF,FW",18-208,2006,0.9,6,4,4,1,1,3,5,60.0,2,1,0,1,0,6,1,0
FRA-Ligue 1,2425,Nantes,Alban Lafont,FRA,GK,26-121,1999,12.0,1,1,1,0,0,1,1,100.0,0,2,0,2,0,1,8,1
FRA-Ligue 1,2425,Nantes,Anthony Lopes,POR,GK,34-235,1990,17.4,1,0,1,0,0,1,1,100.0,0,0,0,0,1,2,7,1
FRA-Ligue 1,2425,Nantes,Bahereba Guirassy,FRA,"FW,MF",18-268,2006,3.9,12,8,6,3,3,7,13,53.8,6,10,0,10,1,13,4,0
FRA-Ligue 1,2425,Nantes,Dehmaine Assoumani,FRA,"MF,FW",20-037,2005,1.1,6,3,0,4,2,4,5,80.0,1,1,0,1,1,7,4,0
FRA-Ligue 1,2425,Nantes,Douglas,BRA,MF,28-131,1997,25.6,69,42,29,31,9,26,44,59.1,18,51,11,40,32,101,47,0
FRA-Ligue 1,2425,Nantes,Fabien Centonze,FRA,DF,29-128,1996,2.9,8,4,5,2,1,4,6,66.7,2,4,1,3,2,10,17,0
FRA-Ligue 1,2425,Nantes,Florent Mollet,FRA,"MF,FW",33-186,1991,2.7,2,2,1,1,0,1,1,100.0,0,2,0,2,1,3,4,0
FRA-Ligue 1,2425,Nantes,Francis Coquelin,FRA,MF,34-011,1991,2.5,9,5,5,3,1,3,4,75.0,1,3,1,2,6,15,3,0
FRA-Ligue 1,2425,Nantes,Ignatius Ganago,CMR,"FW,MF",26-097,1999,2.7,1,1,0,1,0,1,2,50.0,1,3,1,2,4,5,2,0
FRA-Ligue 1,2425,Nantes,Jean-Charles Castelletto,CMR,"DF,MF",30-118,1995,29.1,34,17,17,15,2,17,27,63.0,10,27,18,9,25,59,151,0
FRA-Ligue 1,2425,Nantes,Jean-Kevin Duverne,HAI,DF,27-316,1997,6.0,21,12,13,4,4,15,27,55.6,12,10,3,7,8,29,23,0
FRA-Ligue 1,2425,Nantes,Jean-Philippe Gbamin,CIV,MF,29-241,1995,2.4,2,1,0,2,0,1,4,25.0,3,5,2,3,3,5,2,0
FRA-Ligue 1,2425,Nantes,Johann Lepenant,FRA,MF,22-214,2002,22.8,68,33,30,27,11,32,71,45.1,39,35,3,32,18,86,25,0
FRA-Ligue 1,2425,Nantes,Kelvin Amian,FRA,DF,27-105,1998,24.1,55,31,40,14,1,29,35,82.9,6,18,11,7,13,68,85,0
FRA-Ligue 1,2425,Nantes,Louis Leroux,FRA,"MF,DF",19-121,2006,9.1,25,18,10,12,3,16,22,72.7,6,22,2,20,8,33,19,1
FRA-Ligue 1,2425,Nantes,Marcus Coco,FRA,DF,28-334,1996,10.6,27,21,15,9,3,16,31,51.6,15,16,5,11,11,38,46,0
FRA-Ligue 1,2425,Nantes,Matthis Abline,FRA,FW,22-057,2003,30.8,11,5,2,4,5,3,9,33.3,6,15,1,14,4,15,36,1
FRA-Ligue 1,2425,Nantes,Meschak Elia,COD,FW,27-291,1997,1.9,7,5,3,2,2,1,1,100.0,0,3,0,3,0,7,2,0
FRA-Ligue 1,2425,Nantes,Moses Simon,NGA,"FW,MF",29-316,1995,29.0,20,14,4,7,9,7,22,31.8,15,11,0,11,12,32,13,0
FRA-Ligue 1,2425,Nantes,Mostafa Mohamed,EGY,FW,27-177,1997,13.9,18,9,6,8,4,4,12,33.3,8,10,2,8,10,28,27,0
FRA-Ligue 1,2425,Nantes,Nathan Zeze,FRA,DF,19-340,2005,16.8,38,22,22,16,0,23,33,69.7,10,22,9,13,23,61,120,1
FRA-Ligue 1,2425,Nantes,Nicolas Cozza,FRA,"DF,MF",26-136,1999,22.8,59,41,35,18,6,31,47,66.0,16,25,10,15,25,84,69,0
FRA-Ligue 1,2425,Nantes,Nicolas Pallois,FRA,DF,37-247,1987,22.4,61,27,44,13,4,37,63,58.7,26,48,18,30,28,89,164,3
FRA-Ligue 1,2425,Nantes,Patrik Carlgren,SWE,GK,33-136,1992,4.6,0,0,0,0,0,0,0,,0,0,0,0,0,0,0,0
FRA-Ligue 1,2425,Nantes,Pedro Chirivella,ESP,MF,28-001,1997,26.1,44,29,23,16,5,19,42,45.2,23,25,4,21,19,63,45,0
FRA-Ligue 1,2425,Nantes,Plamedi Nsingi,,MF,24-158,2000,0.2,1,0,1,0,0,0,1,0.0,1,0,0,0,0,1,0,0
FRA-Ligue 1,2425,Nantes,Saidou Sow,GUI,DF,22-324,2002,8.9,17,11,13,4,0,6,10,60.0,4,19,12,7,13,30,46,1
FRA-Ligue 1,2425,Nantes,Sorba Thomas,WAL,"FW,MF",25-275,1999,14.7,14,6,7,5,2,10,18,55.6,8,12,2,10,9,23,27,1
FRA-Ligue 1,2425,Nantes,Sékou Doucoure,FRA,DF,20-028,2005,0.1,0,0,0,0,0,0,0,,0,0,0,0,0,0,3,0
FRA-Ligue 1,2425,Nantes,Tino Kadewere,ZIM,"MF,FW",29-139,1996,5.7,14,8,5,3,6,6,13,46.2,7,3,0,3,6,20,8,0
FRA-Ligue 1,2425,Nice,Ali Abdi,TUN,"DF,MF",31-155,1993,15.5,43,25,18,14,11,28,43,65.1,15,20,6,14,20,63,37,0
FRA-Ligue 1,2425,Nice,Amidou Doumbouya,FRA,DF,17-292,2007,0.5,1,1,0,0,1,1,1,100.0,0,3,1,2,1,2,1,0
FRA-Ligue 1,2425,Nice,Antoine Mendy,SEN,DF,20-362,2004,9.2,30,21,16,14,0,19,29,65.5,10,9,5,4,8,38,29,1
FRA-Ligue 1,2425,Nice,Badredine Bouanani,ALG,"MF,FW",20-167,2004,12.2,11,4,4,4,3,6,18,33.3,12,16,3,13,11,22,4,0
FRA-Ligue 1,2425,Nice,Baptiste Santamaria,FRA,MF,30-076,1995,10.3,20,10,10,7,3,13,22,59.1,9,14,3,11,18,38,19,1
FRA-Ligue 1,2425,Nice,Bernard Nguene,CMR,FW,18-293,2006,0.1,0,0,0,0,0,0,0,,0,0,0,0,0,0,0,0
FRA-Ligue 1,2425,Nice,Bilal Brahimi,ALG,MF,25-071,2000,0.8,0,0,0,0,0,0,0,,0,1,0,1,0,0,2,0
FRA-Ligue 1,2425,Nice,Dante,BRA,DF,41-218,1983,21.8,32,15,17,13,2,15,29,51.7,14,29,14,15,34,66,74,1
FRA-Ligue 1,2425,Nice,Evann Guessand,CIV,"FW,MF",23-327,2001,28.5,44,29,12,15,17,6,14,42.9,8,27,3,24,15,59,16,0
FRA-Ligue 1,2425,Nice,Gaëtan Laborde,FRA,FW,31-021,1994,20.3,19,13,9,8,2,9,22,40.9,13,16,4,12,6,25,20,0
FRA-Ligue 1,2425,Nice,Hicham Boudaoui,ALG,MF,25-243,1999,27.1,76,52,28,37,11,31,53,58.5,22,40,11,29,22,98,45,1
FRA-Ligue 1,2425,Nice,Issiaga Camara,GUI,MF,20-111,2005,0.2,2,1,0,2,0,0,1,0.0,1,0,0,0,3,5,0,0
FRA-Ligue 1,2425,Nice,Jeremie Boga,CIV,"MF,FW",28-141,1997,11.7,10,5,2,5,3,4,8,50.0,4,13,0,13,3,13,2,1
FRA-Ligue 1,2425,Nice,Jonathan Clauss,FRA,"DF,MF",32-241,1992,25.6,52,35,27,19,6,28,56,50.0,28,25,2,23,48,100,68,3
FRA-Ligue 1,2425,Nice,Jordan Lotomba,SUI,"MF,DF",26-237,1998,0.4,0,0,0,0,0,0,0,,0,0,0,0,0,0,1,0
FRA-Ligue 1,2425,Nice,Marcin Bułka,POL,GK,25-232,1999,34.0,0,0,0,0,0,0,1,0.0,1,0,0,0,0,0,16,6
FRA-Ligue 1,2425,Nice,Melvin Bard,FRA,"DF,MF",24-199,2000,21.5,53,36,35,13,5,24,42,57.1,18,38,13,25,29,82,60,3
FRA-Ligue 1,2425,Nice,Mohamed Abdelmoneim,EGY,DF,26-112,1999,9.5,21,14,12,6,3,13,22,59.1,9,11,5,6,15,36,56,1
FRA-Ligue 1,2425,Nice,Mohamed Ali Cho,FRA,"FW,MF",21-125,2004,18.0,13,9,4,5,4,4,12,33.3,8,17,1,16,5,18,8,0
FRA-Ligue 1,2425,Nice,Morgan Sanson,FRA,MF,30-279,1994,2.6,6,3,2,4,0,1,3,33.3,2,3,0,3,4,10,2,0
FRA-Ligue 1,2425,Nice,Moïse Bombito,CAN,DF,25-055,2000,24.4,37,25,22,12,3,24,35,68.6,11,35,19,16,18,55,121,7
FRA-Ligue 1,2425,Nice,Pablo Rosario,NED,"MF,DF",28-137,1997,19.7,30,20,6,19,5,11,20,55.0,9,19,11,8,31,61,43,2
FRA-Ligue 1,2425,Nice,Rareş Ilie,ROU,MF,22-035,2003,0.1,1,1,1,0,0,1,1,100.0,0,0,0,0,0,1,0,0
FRA-Ligue 1,2425,Nice,Sofiane Diop,FRA,"MF,FW",24-349,2000,11.8,23,16,16,3,4,9,22,40.9,13,19,2,17,17,40,7,1
FRA-Ligue 1,2425,Nice,Tanguy Ndombele,FRA,MF,28-147,1996,12.6,35,23,10,21,4,12,20,60.0,8,9,0,9,14,49,9,0
FRA-Ligue 1,2425,Nice,Terem Moffi,NGA,FW,25-364,1999,0.6,0,0,0,0,0,0,0,,0,0,0,0,0,0,0,0
FRA-Ligue 1,2425,Nice,Tom Louchet,FRA,"DF,MF",22-020,2003,8.6,27,17,17,5,5,17,23,73.9,6,12,4,8,18,45,20,0
FRA-Ligue 1,2425,Nice,Victor Orakpo,NGA,FW,18-344,2006,0.4,0,0,0,0,0,0,0,,0,0,0,0,0,0,0,0
FRA-Ligue 1,2425,Nice,Yael Nandjou,FRA,DF,19-322,2005,1.7,4,1,2,1,1,4,8,50.0,4,4,1,3,4,8,7,0
FRA-Ligue 1,2425,Nice,Youssouf Ndayishimiye,BDI,DF,26-209,1998,21.5,40,21,25,14,1,16,27,59.3,11,35,19,16,21,61,117,4
FRA-Ligue 1,2425,Nice,Youssoufa Moukoko,GER,"FW,MF",20-185,2004,2.3,3,2,2,1,0,1,2,50.0,1,2,0,2,0,3,0,0
FRA-Ligue 1,2425,Paris S-G,Achraf Hakimi,MAR,DF,26-201,1998,23.0,48,36,18,20,10,27,55,49.1,28,25,2,23,31,79,18,3
FRA-Ligue 1,2425,Paris S-G,Arnau Tenas,ESP,GK,23-359,2001,1.0,0,0,0,0,0,0,0,,0,0,0,0,0,0,0,0
FRA-Ligue 1,2425,Paris S-G,Axel Tapé,FRA,"DF,MF",17-287,2007,2.0,3,1,1,2,0,2,2,100.0,0,2,2,0,1,4,5,0
FRA-Ligue 1,2425,Paris S-G,Bradley Barcola,FRA,FW,22-264,2002,24.2,27,17,10,8,9,8,31,25.8,23,25,2,23,19,46,12,0
FRA-Ligue 1,2425,Paris S-G,Désiré Doué,FRA,"FW,MF",19-355,2005,19.2,48,30,15,19,14,24,51,47.1,27,26,0,26,13,61,7,0
FRA-Ligue 1,2425,Paris S-G,Fabián Ruiz Peña,ESP,MF,29-051,1996,21.4,37,24,13,15,9,21,47,44.7,26,25,3,22,16,53,27,1
FRA-Ligue 1,2425,Paris S-G,Gianluigi Donnarumma,ITA,GK,26-088,1999,23.2,1,1,1,0,0,1,2,50.0,1,0,0,0,0,1,14,0
FRA-Ligue 1,2425,Paris S-G,Gonçalo Ramos,POR,FW,23-338,2001,11.8,11,6,5,5,1,3,6,50.0,3,5,1,4,0,11,5,0
FRA-Ligue 1,2425,Paris S-G,Ibrahim Mbaye,FRA,"FW,MF",17-120,2008,3.8,4,2,1,2,1,3,8,37.5,5,2,0,2,2,6,2,0
FRA-Ligue 1,2425,Paris S-G,João Neves,POR,"MF,DF",20-239,2004,20.5,63,31,20,26,17,27,45,60.0,18,29,9,20,23,86,22,1
FRA-Ligue 1,2425,Paris S-G,Khvicha Kvaratskhelia,GEO,FW,24-101,2001,10.2,19,13,4,12,3,13,23,56.5,10,7,0,7,2,21,4,0
FRA-Ligue 1,2425,Paris S-G,Lee Kang-in,KOR,"FW,MF",24-094,2001,18.5,25,17,7,11,7,19,35,54.3,16,11,1,10,3,28,3,1
FRA-Ligue 1,2425,Paris S-G,Lucas Beraldo,BRA,DF,21-181,2003,22.3,38,31,30,8,0,23,37,62.2,14,16,8,8,21,59,63,3
FRA-Ligue 1,2425,Paris S-G,Lucas Hernández,FRA,DF,29-099,1996,9.7,24,18,13,9,2,14,23,60.9,9,12,5,7,7,31,37,2
FRA-Ligue 1,2425,Paris S-G,Marco Asensio,ESP,"FW,MF",29-123,1996,6.9,4,3,1,3,0,0,6,0.0,6,1,0,1,0,4,1,0
FRA-Ligue 1,2425,Paris S-G,Marquinhos,BRA,DF,31-010,1994,19.2,30,19,8,16,6,25,33,75.8,8,27,15,12,11,41,64,0
FRA-Ligue 1,2425,Paris S-G,Matvei Safonov,RUS,GK,26-088,1999,9.8,0,0,0,0,0,0,0,,0,1,0,1,1,1,3,0
FRA-Ligue 1,2425,Paris S-G,Milan Škriniar,SVK,DF,30-102,1995,4.2,7,5,3,4,0,3,3,100.0,0,7,6,1,3,10,16,0
FRA-Ligue 1,2425,Paris S-G,Noham Kamara,FRA,DF,18-122,2007,0.8,1,1,0,1,0,0,0,,0,1,1,0,1,2,1,0
FRA-Ligue 1,2425,Paris S-G,Nuno Mendes,POR,DF,22-339,2002,18.6,30,19,15,12,3,23,39,59.0,16,25,8,17,18,48,37,2
FRA-Ligue 1,2425,Paris S-G,Ousmane Dembélé,FRA,FW,28-009,1997,19.2,11,5,0,7,4,4,12,33.3,8,3,0,3,9,20,2,1
FRA-Ligue 1,2425,Paris S-G,Presnel Kimpembe,FRA,DF,29-284,1995,0.3,1,0,1,0,0,0,0,,0,2,2,0,0,1,1,0
FRA-Ligue 1,2425,Paris S-G,Randal Kolo Muani,FRA,FW,26-170,1998,4.0,4,4,1,1,2,0,2,0.0,2,1,0,1,0,4,5,0
FRA-Ligue 1,2425,Paris S-G,Senny Mayulu,FRA,MF,19-007,2006,9.0,25,16,8,14,3,8,14,57.1,6,8,3,5,5,30,12,0
FRA-Ligue 1,2425,Paris S-G,Vitinha,POR,MF,25-100,2000,22.7,43,23,13,27,3,25,48,52.1,23,26,7,19,14,57,19,2
FRA-Ligue 1,2425,Paris S-G,Warren Zaïre-Emery,FRA,"MF,DF",19-077,2006,22.8,51,26,17,21,13,23,45,51.1,22,35,6,29,23,74,20,2
FRA-Ligue 1,2425,Paris S-G,Willian Pacho,ECU,DF,23-220,2001,23.7,56,32,34,22,0,23,32,71.9,9,35,22,13,40,96,91,1
FRA-Ligue 1,2425,Paris S-G,Yoram Zague,FRA,"DF,FW",19-009,2006,2.0,8,6,3,1,4,6,8,75.0,2,3,0,3,2,10,2,0
FRA-Ligue 1,2425,Reims,Abdoul Koné,FRA,DF,20-032,2005,1.5,5,3,4,1,0,3,5,60.0,2,2,1,1,1,6,5,0
FRA-Ligue 1,2425,Reims,Amadou Koné,MLI,MF,20-010,2005,14.4,49,32,32,16,1,22,35,62.9,13,18,4,14,19,68,38,2
FRA-Ligue 1,2425,Reims,Amine Salama,FRA,FW,24-310,2000,4.1,3,2,0,2,1,0,3,0.0,3,2,1,1,1,4,0,0
FRA-Ligue 1,2425,Reims,Ange Martial Tia,MLI,"MF,DF",18-185,2006,1.9,4,3,1,2,1,2,6,33.3,4,3,0,3,2,6,4,0
FRA-Ligue 1,2425,Reims,Aurélio Buta,POR,DF,28-103,1997,21.9,37,24,22,11,4,21,42,50.0,21,19,5,14,22,59,59,0
FRA-Ligue 1,2425,Reims,Cédric Kipré,CIV,DF,28-166,1996,24.3,42,30,30,11,1,29,39,74.4,10,42,27,15,32,74,162,2
FRA-Ligue 1,2425,Reims,Eloge Zabi,CIV,"DF,MF",18-242,2006,0.2,0,0,0,0,0,0,0,,0,0,0,0,0,0,1,0
FRA-Ligue 1,2425,Reims,Emmanuel Agbadou,CIV,DF,27-341,1997,14.0,25,17,19,3,3,19,26,73.1,7,22,13,9,19,44,64,1
FRA-Ligue 1,2425,Reims,Gabriel Moscardo,BRA,"MF,DF",19-238,2005,0.9,3,1,2,1,0,1,3,33.3,2,3,1,2,0,3,1,0
FRA-Ligue 1,2425,Reims,Hafiz Ibrahim,NGA,FW,19-155,2005,4.3,3,2,0,1,2,0,5,0.0,5,4,2,2,2,5,6,0
FRA-Ligue 1,2425,Reims,Hiroki Sekine,JPN,DF,22-286,2002,9.9,9,7,6,2,1,7,17,41.2,10,22,11,11,5,14,51,1
FRA-Ligue 1,2425,Reims,Ike Orazi,IRL,MF,17-347,2007,0.0,0,0,0,0,0,0,0,,0,0,0,0,0,0,0,0
FRA-Ligue 1,2425,Reims,John Joe,IRL,MF,21-212,2003,6.1,24,15,11,10,3,7,19,36.8,12,11,2,9,6,30,9,0
FRA-Ligue 1,2425,Reims,Jordan Pefok,USA,FW,29-028,1996,4.2,3,2,0,3,0,2,3,66.7,1,3,1,2,2,5,5,0
FRA-Ligue 1,2425,Reims,Joseph Okumu,KEN,DF,27-363,1997,18.8,30,15,21,9,0,15,24,62.5,9,33,21,12,25,55,137,2
FRA-Ligue 1,2425,Reims,Junya Ito,JPN,"FW,MF",32-076,1993,29.9,45,30,19,16,10,17,60,28.3,43,33,3,30,13,58,15,2
FRA-Ligue 1,2425,Reims,Keito Nakamura,JPN,"FW,MF",24-300,2000,29.4,24,16,7,10,7,11,31,35.5,20,21,1,20,13,37,19,0
FRA-Ligue 1,2425,Reims,Malcolm Jeng,SWE,DF,20-076,2005,1.2,0,0,0,0,0,0,0,,0,1,0,1,3,3,10,0
FRA-Ligue 1,2425,Reims,Mamadou Diakhon,FRA,"FW,MF",19-244,2005,9.5,12,8,4,3,5,9,18,50.0,9,5,1,4,4,16,5,0
FRA-Ligue 1,2425,Reims,Marshall Munetsi,ZIM,MF,28-336,1996,18.8,36,18,22,9,5,22,38,57.9,16,27,3,24,17,53,35,0
FRA-Ligue 1,2425,Reims,Martin Adeline,FRA,MF,21-173,2003,0.3,1,1,0,1,0,1,2,50.0,1,0,0,0,0,1,2,0
FRA-Ligue 1,2425,Reims,Mohamed Bamba,CIV,MF,20-228,2004,0.1,0,0,0,0,0,0,1,0.0,1,2,1,1,0,0,1,0
FRA-Ligue 1,2425,Reims,Mohamed Daramy,DEN,FW,23-137,2002,0.2,0,0,0,0,0,0,0,,0,0,0,0,0,0,1,0
FRA-Ligue 1,2425,Reims,Mory Gbane,CIV,"DF,MF",24-150,2000,12.5,20,11,16,4,0,13,24,54.2,11,12,10,2,18,38,90,1
FRA-Ligue 1,2425,Reims,Nhoa Sangui,FRA,"DF,MF",19-086,2006,12.9,16,9,6,6,4,9,12,75.0,3,8,4,4,8,24,23,0
FRA-Ligue 1,2425,Reims,Niama Sissoko,MLI,"FW,MF",19-159,2005,0.5,0,0,0,0,0,0,0,,0,1,0,1,0,0,0,0
FRA-Ligue 1,2425,Reims,Oumar Diakité,CIV,FW,21-155,2003,18.1,20,13,7,8,5,9,19,47.4,10,13,2,11,3,23,9,0
FRA-Ligue 1,2425,Reims,Reda Khadra,GER,"MF,FW",23-324,2001,0.9,1,1,1,0,0,0,1,0.0,1,0,0,0,0,1,1,0
FRA-Ligue 1,2425,Reims,Sergio Akieme,ESP,DF,27-159,1997,28.0,34,23,30,3,1,22,36,61.1,14,26,9,17,17,51,97,4
FRA-Ligue 1,2425,Reims,Teddy Teuma,MLT,MF,31-236,1993,8.3,18,10,6,6,6,7,25,28.0,18,12,2,10,12,30,8,1
FRA-Ligue 1,2425,Reims,Thibault De Smet,BEL,DF,26-353,1998,2.1,6,4,5,1,0,4,4,100.0,0,5,3,2,4,10,12,0
FRA-Ligue 1,2425,Reims,Valentin Atangana Edoa,FRA,MF,19-272,2005,31.7,69,50,32,30,7,28,38,73.7,10,31,15,16,37,106,64,0
FRA-Ligue 1,2425,Reims,Yaya Kader Fofana,MLI,"MF,FW",20-346,2004,7.0,17,11,8,5,4,4,12,33.3,8,11,2,9,3,20,2,0
FRA-Ligue 1,2425,Reims,Yehvann Diouf,FRA,GK,25-189,1999,34.0,2,1,2,0,0,1,3,33.3,2,0,0,0,1,3,22,4
FRA-Ligue 1,2425,Rennes,Adrien Truffert,FRA,"DF,MF",23-185,2001,30.6,61,36,27,21,13,32,48,66.7,16,44,6,38,27,88,56,1
FRA-Ligue 1,2425,Rennes,Albert Grønbaek,DEN,"MF,FW",24-001,2001,9.0,21,11,10,7,4,10,28,35.7,18,9,1,8,4,25,6,0
FRA-Ligue 1,2425,Rennes,Alidu Seidu,GHA,DF,24-354,2000,8.9,22,18,14,6,2,12,15,80.0,3,13,6,7,14,36,17,0
FRA-Ligue 1,2425,Rennes,Amine Gouiri,ALG,"MF,FW",25-097,2000,11.5,9,6,4,4,1,2,8,25.0,6,8,0,8,2,11,5,0
FRA-Ligue 1,2425,Rennes,Anthony Rouault,FRA,DF,23-360,2001,10.8,12,8,10,2,0,4,4,100.0,0,13,11,2,8,20,65,0
FRA-Ligue 1,2425,Rennes,Arnaud Kalimuendo,FRA,"FW,MF",23-124,2002,28.6,19,12,6,9,4,7,15,46.7,8,9,2,7,4,23,16,1
FRA-Ligue 1,2425,Rennes,Ayanda Sishuba,BEL,FW,20-111,2005,0.0,1,0,1,0,0,1,1,100.0,0,0,0,0,0,1,0,0
FRA-Ligue 1,2425,Rennes,Azor Matusiwa,NED,MF,27-026,1998,23.1,64,39,32,30,2,32,43,74.4,11,29,10,19,34,98,52,0
FRA-Ligue 1,2425,Rennes,Baptiste Santamaria,FRA,MF,30-076,1995,5.4,11,4,7,3,1,6,11,54.5,5,10,4,6,12,23,7,0
FRA-Ligue 1,2425,Rennes,Benjamin Bourigeaud,FRA,MF,31-130,1994,0.9,1,0,0,1,0,0,2,0.0,2,2,1,1,2,3,1,0
FRA-Ligue 1,2425,Rennes,Brice Samba,FRA,GK,31-029,1994,17.0,2,1,2,0,0,1,2,50.0,1,0,0,0,0,2,12,3
FRA-Ligue 1,2425,Rennes,Carlos Gómez,COL,"MF,DF",22-254,2002,4.2,8,6,3,4,1,3,9,33.3,6,6,0,6,2,10,2,0
FRA-Ligue 1,2425,Rennes,Christopher Wooh,CMR,DF,23-248,2001,16.2,36,19,21,13,2,18,27,66.7,9,22,8,14,23,59,63,0
FRA-Ligue 1,2425,Rennes,Djaoui Cissé,FRA,MF,21-113,2004,12.5,33,18,12,15,6,16,26,61.5,10,29,4,25,13,46,11,1
FRA-Ligue 1,2425,Rennes,Gauthier Gallon,FRA,GK,32-031,1993,0.5,0,0,0,0,0,0,0,,0,0,0,0,0,0,0,0
FRA-Ligue 1,2425,Rennes,Glen Kamara,FIN,MF,29-208,1995,7.4,23,11,10,11,2,11,17,64.7,6,7,0,7,7,30,7,0
FRA-Ligue 1,2425,Rennes,Hans Hateboer,NED,DF,31-135,1994,18.7,31,16,14,12,5,18,36,50.0,18,19,6,13,29,60,64,2
FRA-Ligue 1,2425,Rennes,Henrik Meister,DEN,FW,21-188,2003,0.7,2,0,0,2,0,0,0,,0,4,0,4,1,3,0,0
FRA-Ligue 1,2425,Rennes,Ismaël Koné,CAN,MF,22-352,2002,5.2,9,6,4,4,1,5,7,71.4,2,9,2,7,4,13,5,0
FRA-Ligue 1,2425,Rennes,Jordan James,WAL,MF,20-326,2004,13.1,30,19,8,18,4,16,30,53.3,14,14,1,13,14,44,17,1
FRA-Ligue 1,2425,Rennes,Jota,POR,"FW,MF",26-055,1999,3.7,5,2,2,3,0,4,7,57.1,3,1,0,1,3,8,2,0
FRA-Ligue 1,2425,Rennes,Jérémy Jacquet,FRA,DF,19-315,2005,10.3,26,17,11,8,7,14,22,63.6,8,9,3,6,27,53,45,1
FRA-Ligue 1,2425,Rennes,Kazeem Olaigbe,BEL,"MF,FW",22-142,2003,3.3,6,4,3,3,0,3,6,50.0,3,3,1,2,0,6,0,0
FRA-Ligue 1,2425,Rennes,Kyogo Furuhashi,JPN,FW,30-124,1995,1.4,2,2,1,1,0,1,1,100.0,0,0,0,0,0,2,0,0
FRA-Ligue 1,2425,Rennes,Leo Skiri Østigård,NOR,DF,25-177,1999,13.6,20,18,16,4,0,15,22,68.2,7,12,10,2,15,35,81,1
FRA-Ligue 1,2425,Rennes,Lilian Brassier,FRA,DF,25-203,1999,13.7,15,12,11,4,0,9,11,81.8,2,17,10,7,22,37,62,1
FRA-Ligue 1,2425,Rennes,Lorenz Assignon,TOG,"DF,MF",24-336,2000,26.2,49,27,25,22,2,19,43,44.2,24,20,3,17,25,74,74,0
FRA-Ligue 1,2425,Rennes,Ludovic Blas,FRA,"MF,FW",27-144,1997,25.5,38,25,9,12,17,23,42,54.8,19,16,2,14,13,51,11,0
FRA-Ligue 1,2425,Rennes,Mahamadou Nagida,CMR,DF,19-330,2005,4.8,8,6,4,3,1,4,5,80.0,1,3,0,3,9,17,6,0
FRA-Ligue 1,2425,Rennes,Mikayil Ngor Faye,SEN,DF,20-314,2004,7.6,15,12,10,3,2,7,9,77.8,2,9,4,5,12,27,30,0
FRA-Ligue 1,2425,Rennes,Mohamed Meité,FRA,FW,17-225,2007,6.0,2,0,0,2,0,1,1,100.0,0,1,0,1,0,2,5,0
FRA-Ligue 1,2425,Rennes,Musa Al-Taamari,JOR,"FW,MF",27-348,1997,6.3,4,1,1,1,2,0,4,0.0,4,5,0,5,2,6,2,0
FRA-Ligue 1,2425,Rennes,Naouirou Ahamada,FRA,"MF,FW",23-056,2002,0.6,0,0,0,0,0,0,0,,0,0,0,0,2,2,2,0
FRA-Ligue 1,2425,Rennes,Seko Fofana,CIV,MF,30-017,1995,9.4,11,7,4,6,1,2,7,28.6,5,7,1,6,7,18,7,0
FRA-Ligue 1,2425,Rennes,Steve Mandanda,FRA,GK,40-057,1985,16.5,0,0,0,0,0,0,1,0.0,1,0,0,0,0,0,6,2
FRA-Ligue 1,2425,Saint-Étienne,Aimen Moueffek,FRA,MF,24-045,2001,11.5,20,12,3,11,6,10,23,43.5,13,20,7,13,5,25,26,1
FRA-Ligue 1,2425,Saint-Étienne,Anthony Briançon,FRA,DF,30-177,1994,0.0,0,0,0,0,0,0,0,,0,0,0,0,0,0,0,0
FRA-Ligue 1,2425,Saint-Étienne,Augustine Boakye,GHA,"FW,MF",24-202,2000,8.1,7,3,3,4,0,3,11,27.3,8,5,0,5,6,13,4,0
FRA-Ligue 1,2425,Saint-Étienne,Ayman Aiki,FRA,"FW,MF",19-333,2005,1.4,3,3,1,2,0,1,1,100.0,0,1,0,1,1,4,0,0
FRA-Ligue 1,2425,Saint-Étienne,Ben Old,NZL,"FW,MF",22-284,2002,5.9,7,5,3,3,1,3,11,27.3,8,8,1,7,2,9,2,0
FRA-Ligue 1,2425,Saint-Étienne,Benjamin Bouchouari,MAR,MF,23-192,2001,19.7,33,27,15,13,5,16,46,34.8,30,21,1,20,17,50,15,2
FRA-Ligue 1,2425,Saint-Étienne,Beres Owusu,FRA,DF,21-247,2003,1.0,2,2,1,1,0,2,2,100.0,0,2,2,0,0,2,5,0
FRA-Ligue 1,2425,Saint-Étienne,Dennis Appiah,FRA,DF,32-349,1992,23.6,71,43,42,22,7,41,71,57.7,30,36,8,28,29,100,89,2
FRA-Ligue 1,2425,Saint-Étienne,Djylian N'Guessan,FRA,FW,16-267,2008,2.0,6,4,5,1,0,2,5,40.0,3,1,0,1,0,6,1,0
FRA-Ligue 1,2425,Saint-Étienne,Dylan Batubinsika,COD,DF,29-098,1996,22.4,26,13,19,6,1,13,22,59.1,9,23,14,9,39,65,140,3
FRA-Ligue 1,2425,Saint-Étienne,Florian Tardieu,FRA,MF,33-032,1992,13.9,18,14,6,9,3,6,17,35.3,11,18,5,13,15,33,21,0
FRA-Ligue 1,2425,Saint-Étienne,Gautier Larsonneur,FRA,GK,28-090,1997,34.0,1,0,1,0,0,0,2,0.0,2,1,0,1,0,1,25,1
FRA-Ligue 1,2425,Saint-Étienne,Ibrahim Sissoko,MLI,FW,29-178,1995,9.1,11,9,5,3,3,2,5,40.0,3,10,2,8,2,13,13,0
FRA-Ligue 1,2425,Saint-Étienne,Ibrahima Wadji,SEN,"FW,MF",30-019,1995,3.9,7,6,3,3,1,3,7,42.9,4,1,0,1,1,8,0,0
FRA-Ligue 1,2425,Saint-Étienne,Igor Miladinović,SRB,"FW,MF",21-350,2003,0.3,0,0,0,0,0,0,0,,0,0,0,0,1,1,1,0
FRA-Ligue 1,2425,Saint-Étienne,Irvin Cardona,FRA,FW,27-289,1997,11.8,6,5,3,3,0,2,14,14.3,12,16,3,13,4,10,6,2
FRA-Ligue 1,2425,Saint-Étienne,Jibril Othman,TUN,FW,21-028,2004,0.1,0,0,0,0,0,0,0,,0,0,0,0,0,0,0,0
FRA-Ligue 1,2425,Saint-Étienne,Kévin Pedro,FRA,DF,19-092,2006,0.1,3,0,2,1,0,3,3,100.0,0,1,0,1,2,5,1,0
FRA-Ligue 1,2425,Saint-Étienne,Lamine Fomba,FRA,MF,27-118,1998,2.4,8,6,2,5,1,2,7,28.6,5,7,1,6,4,12,5,1
FRA-Ligue 1,2425,Saint-Étienne,Louis Mouton,FRA,MF,22-355,2002,11.6,49,25,14,25,10,22,37,59.5,15,17,3,14,10,59,19,0
FRA-Ligue 1,2425,Saint-Étienne,Lucas Stassin,BEL,FW,20-177,2004,21.0,16,11,3,5,8,6,20,30.0,14,10,0,10,3,19,8,0
FRA-Ligue 1,2425,Saint-Étienne,Léo Pétrot,FRA,DF,28-039,1997,29.3,62,39,38,19,5,34,51,66.7,17,50,27,23,42,104,103,1
FRA-Ligue 1,2425,Saint-Étienne,Marwann Nzuzi,FRA,DF,21-008,2004,1.4,2,2,1,0,1,1,2,50.0,1,0,0,0,2,4,6,0
FRA-Ligue 1,2425,Saint-Étienne,Mathieu Cafaro,FRA,"MF,FW",28-060,1997,8.1,10,7,4,4,2,4,15,26.7,11,7,1,6,7,17,3,0
FRA-Ligue 1,2425,Saint-Étienne,Mathis Amougou,FRA,MF,19-126,2006,9.5,21,15,15,5,1,10,19,52.6,9,10,0,10,12,33,4,0
FRA-Ligue 1,2425,Saint-Étienne,Maxime Bernauer,FRA,DF,26-327,1998,8.5,9,9,5,2,2,5,8,62.5,3,7,3,4,5,14,44,1
FRA-Ligue 1,2425,Saint-Étienne,Mickael Nade,FRA,DF,26-081,1999,25.6,59,43,40,19,0,28,36,77.8,8,37,19,18,33,92,132,8
FRA-Ligue 1,2425,Saint-Étienne,Pierre Cornud,FRA,DF,28-163,1996,6.4,12,10,6,4,2,8,17,47.1,9,9,4,5,9,21,28,1
FRA-Ligue 1,2425,Saint-Étienne,Pierre Ekwah Elimby,FRA,MF,23-129,2002,28.6,54,33,18,30,6,34,56,60.7,22,26,12,14,47,101,72,1
FRA-Ligue 1,2425,Saint-Étienne,Yunis Abdelhamid,MAR,DF,37-238,1987,11.5,17,11,15,2,0,10,16,62.5,6,26,18,8,14,31,57,1
FRA-Ligue 1,2425,Saint-Étienne,Yvann Macon,FRA,DF,26-235,1998,8.8,19,11,9,7,3,10,21,47.6,11,14,4,10,2,21,10,1
FRA-Ligue 1,2425,Saint-Étienne,Zuriko Davitashvili,GEO,"FW,MF",24-098,2001,30.9,22,14,9,7,6,15,49,30.6,34,20,0,20,14,36,14,0
FRA-Ligue 1,2425,Strasbourg,Abakar Sylla,CIV,DF,22-150,2002,10.6,27,15,14,11,2,15,17,88.2,2,18,10,8,11,38,63,0
FRA-Ligue 1,2425,Strasbourg,Andrew Omobamidele,IRL,DF,22-335,2002,6.0,7,4,4,3,0,2,5,40.0,3,12,8,4,8,15,41,0
FRA-Ligue 1,2425,Strasbourg,Andrey Santos,BRA,MF,21-021,2004,31.7,110,74,47,51,12,51,87,58.6,36,46,14,32,32,142,67,1
FRA-Ligue 1,2425,Strasbourg,Caleb Wiley,USA,"DF,MF",20-153,2004,3.0,1,0,0,1,0,0,1,0.0,1,3,1,2,4,5,5,0
FRA-Ligue 1,2425,Strasbourg,Diego Moreira,POR,"DF,MF",20-291,2004,28.5,44,28,17,19,8,24,50,48.0,26,23,4,19,35,79,65,0
FRA-Ligue 1,2425,Strasbourg,Dilane Bakwa,FRA,"MF,DF",22-271,2002,27.7,26,14,11,8,7,12,24,50.0,12,21,1,20,15,41,27,0
FRA-Ligue 1,2425,Strasbourg,Eduard Sobol,UKR,DF,30-034,1995,1.1,0,0,0,0,0,0,2,0.0,2,2,1,1,2,2,14,0
FRA-Ligue 1,2425,Strasbourg,Emanuel Emegha,NED,FW,22-110,2003,25.5,6,6,1,2,3,2,6,33.3,4,18,5,13,1,7,30,0
FRA-Ligue 1,2425,Strasbourg,Félix Lemaréchal,FRA,"MF,FW",21-290,2003,19.8,35,24,13,17,5,14,29,48.3,15,35,4,31,14,49,19,0
FRA-Ligue 1,2425,Strasbourg,Guela Doué,CIV,DF,22-219,2002,30.2,65,45,40,15,10,37,54,68.5,17,38,6,32,34,99,154,1
FRA-Ligue 1,2425,Strasbourg,Guimissongui Ouattara,FRA,"DF,FW",19-214,2005,5.2,6,4,3,1,2,3,5,60.0,2,10,0,10,9,15,12,2
FRA-Ligue 1,2425,Strasbourg,Habib Diarra,SEN,"MF,FW",21-141,2004,26.1,22,13,6,13,3,8,20,40.0,12,22,6,16,13,35,46,3
FRA-Ligue 1,2425,Strasbourg,Ismaël Doukouré,FRA,"DF,MF",21-304,2003,29.3,40,22,19,18,3,17,25,68.0,8,31,14,17,25,65,102,3
FRA-Ligue 1,2425,Strasbourg,Junior Mwanga,FRA,MF,22-013,2003,3.3,17,9,9,7,1,5,9,55.6,4,2,0,2,2,19,2,0
FRA-Ligue 1,2425,Strasbourg,Jérémy Sebas,MTQ,"FW,MF",22-040,2003,2.1,3,2,1,1,1,2,3,66.7,1,2,0,2,0,3,4,0
FRA-Ligue 1,2425,Strasbourg,Karl-Johan Johnsson,SWE,GK,35-116,1990,3.0,0,0,0,0,0,0,1,0.0,1,0,0,0,0,0,3,0
FRA-Ligue 1,2425,Strasbourg,Karol Fila,POL,MF,26-345,1998,0.1,0,0,0,0,0,0,0,,0,0,0,0,0,0,0,0
FRA-Ligue 1,2425,Strasbourg,Mamadou Sarr,FRA,DF,19-268,2005,26.3,37,21,24,11,2,16,24,66.7,8,26,20,6,25,62,117,3
FRA-Ligue 1,2425,Strasbourg,Marvin Senaya,TOG,DF,24-116,2001,2.5,8,3,5,2,1,6,12,50.0,6,6,2,4,7,15,12,0
FRA-Ligue 1,2425,Strasbourg,Milos Lukovic,SRB,"FW,MF",19-187,2005,0.1,0,0,0,0,0,0,0,,0,0,0,0,0,0,0,0
FRA-Ligue 1,2425,Strasbourg,Nordine Kandil,FRA,MF,23-205,2001,0.1,0,0,0,0,0,0,0,,0,0,0,0,0,0,1,0
FRA-Ligue 1,2425,Strasbourg,Pape Daouda Diongue,SEN,"MF,FW",,,0.9,2,0,1,1,0,1,2,50.0,1,0,0,0,3,5,2,0
FRA-Ligue 1,2425,Strasbourg,Saidou Sow,GUI,DF,22-324,2002,11.3,9,5,6,3,0,6,12,50.0,6,15,9,6,15,24,37,2
FRA-Ligue 1,2425,Strasbourg,Samuel Amo-Ameyaw,ENG,"DF,MF",18-310,2006,3.6,5,3,3,2,0,2,9,22.2,7,3,0,3,3,8,2,0
FRA-Ligue 1,2425,Strasbourg,Sebastian Nanasi,SWE,"MF,FW",23-008,2002,23.4,20,13,6,12,2,8,22,36.4,14,24,3,21,7,27,18,0
FRA-Ligue 1,2425,Strasbourg,Sekou Mara,FRA,"FW,MF",22-298,2002,8.5,9,6,0,5,4,3,9,33.3,6,11,0,11,3,12,3,0
FRA-Ligue 1,2425,Strasbourg,Thomas Delaine,FRA,DF,33-061,1992,0.1,1,1,1,0,0,1,1,100.0,0,0,0,0,1,2,1,0
FRA-Ligue 1,2425,Strasbourg,Valentín Barco,ARG,"MF,DF",20-305,2004,12.9,36,22,24,10,2,22,30,73.3,8,8,3,5,13,49,28,1
FRA-Ligue 1,2425,Strasbourg,Óscar Perea,COL,"MF,DF",19-239,2005,0.2,0,0,0,0,0,0,0,,0,0,0,0,0,0,0,0
FRA-Ligue 1,2425,Strasbourg,Đorđe Petrović,SRB,GK,25-228,1999,31.0,1,1,1,0,0,0,0,,0,0,0,0,0,1,24,1
FRA-Ligue 1,2425,Toulouse,Aron Dønnum,NOR,"DF,MF",27-034,1998,29.9,56,35,25,24,7,31,55,56.4,24,29,4,25,28,84,37,1
FRA-Ligue 1,2425,Toulouse,Charlie Cresswell,ENG,DF,22-280,2002,28.8,35,23,19,15,1,28,46,60.9,18,44,28,16,28,63,191,3
FRA-Ligue 1,2425,Toulouse,Cristian Cásseres Jr.,VEN,MF,25-124,2000,30.0,96,61,41,43,12,46,88,52.3,42,35,9,26,42,138,36,1
FRA-Ligue 1,2425,Toulouse,Denis Genreau,AUS,MF,26-003,1999,2.5,7,5,4,1,2,4,8,50.0,4,3,0,3,3,10,4,0
FRA-Ligue 1,2425,Toulouse,Djibril Sidibé,FRA,DF,32-299,1992,23.3,65,36,34,22,9,31,50,62.0,19,11,3,8,20,85,64,1
FRA-Ligue 1,2425,Toulouse,Edhy Zuliani,ITA,DF,20-286,2004,0.1,0,0,0,0,0,0,0,,0,0,0,0,1,1,0,0
FRA-Ligue 1,2425,Toulouse,Frank Magri,CMR,"FW,MF",25-262,1999,16.8,8,2,1,6,1,3,8,37.5,5,16,2,14,4,12,11,0
FRA-Ligue 1,2425,Toulouse,Gabriel Suazo,CHI,DF,27-288,1997,24.0,59,39,25,22,12,30,72,41.7,42,27,3,24,36,95,40,1
FRA-Ligue 1,2425,Toulouse,Guillaume Restes,FRA,GK,20-074,2005,28.3,2,1,2,0,0,2,3,66.7,1,0,0,0,1,3,16,1
FRA-Ligue 1,2425,Toulouse,Jaydee Canvot,FRA,"DF,MF",18-299,2006,12.3,23,11,16,5,2,12,18,66.7,6,10,2,8,11,34,54,1
FRA-Ligue 1,2425,Toulouse,Joshua King,NOR,"FW,MF",33-129,1992,18.6,11,11,4,4,3,5,12,41.7,7,10,3,7,6,17,19,0
FRA-Ligue 1,2425,Toulouse,Kjetil Haug,NOR,GK,26-346,1998,5.5,0,0,0,0,0,0,0,,0,0,0,0,0,0,3,0
FRA-Ligue 1,2425,Toulouse,Logan Costa,CPV,DF,24-053,2001,1.0,2,1,0,2,0,1,1,100.0,0,2,2,0,2,4,4,0
FRA-Ligue 1,2425,Toulouse,Mark McKenzie,USA,DF,26-088,1999,27.7,52,31,31,20,1,33,45,73.3,12,31,18,13,22,74,141,1
FRA-Ligue 1,2425,Toulouse,Miha Zajc,SVN,MF,30-327,1994,2.9,4,4,1,2,1,3,5,60.0,2,2,1,1,3,7,7,0
FRA-Ligue 1,2425,Toulouse,Naatan Skyttä,FIN,FW,23-017,2002,0.1,1,0,0,0,1,0,0,,0,0,0,0,0,1,0,0
FRA-Ligue 1,2425,Toulouse,Niklas Schmidt,GER,MF,27-084,1998,2.3,6,4,1,5,0,4,7,57.1,3,0,0,0,1,7,4,0
FRA-Ligue 1,2425,Toulouse,Noah Edjouma,FRA,"MF,FW",19-232,2005,1.9,2,2,0,1,1,1,2,50.0,1,1,1,0,2,4,2,0
FRA-Ligue 1,2425,Toulouse,Rafik Messali,FRA,DF,22-026,2003,5.1,15,8,6,6,3,7,8,87.5,1,9,1,8,10,25,12,0
FRA-Ligue 1,2425,Toulouse,Rasmus Nicolaisen,DEN,DF,28-069,1997,6.9,6,3,4,2,0,3,5,60.0,2,10,5,5,10,16,25,0
FRA-Ligue 1,2425,Toulouse,Shavy Babicka,GAB,"MF,FW",24-357,2000,13.2,21,12,6,11,4,10,21,47.6,11,14,0,14,3,24,4,3
FRA-Ligue 1,2425,Toulouse,Vincent Sierro,SUI,MF,29-228,1995,26.7,44,27,15,23,6,27,56,48.2,29,34,9,25,16,60,44,1
FRA-Ligue 1,2425,Toulouse,Waren Kamanzi,NOR,"DF,MF",24-194,2000,11.4,29,13,12,12,5,14,28,50.0,14,7,3,4,9,38,25,0
FRA-Ligue 1,2425,Toulouse,Yann Gboho,FRA,"MF,FW",24-130,2001,25.9,31,18,7,15,9,14,35,40.0,21,20,0,20,6,37,4,1
FRA-Ligue 1,2425,Toulouse,Zakaria Aboukhlal,MAR,"MF,FW",25-095,2000,21.1,22,13,7,8,7,4,23,17.4,19,16,1,15,6,28,9,0
FRA-Ligue 1,2425,Toulouse,Álex Domínguez,ESP,GK,26-298,1998,0.2,0,0,0,0,0,0,0,,0,0,0,0,0,0,0,0
FRA-Ligue 1,2425,Toulouse,Ümit Akdag,ROU,DF,21-230,2003,5.6,8,4,3,4,1,5,12,41.7,7,10,8,2,11,19,19,0
GER-Bundesliga,2425,Augsburg,Alexis Claude-Maurice,FRA,"MF,FW",26-352,1998,23.4,41,26,12,15,14,17,34,50.0,17,16,0,16,15,56,8,1
GER-Bundesliga,2425,Augsburg,Arne Engels,BEL,"MF,FW",21-258,2003,0.9,0,0,0,0,0,0,0,,0,1,1,0,0,0,0,0
GER-Bundesliga,2425,Augsburg,Arne Maier,GER,MF,26-136,1999,10.4,13,7,4,8,1,7,13,53.8,6,15,1,14,6,19,14,1
GER-Bundesliga,2425,Augsburg,Cedric Zesiger,SUI,DF,26-334,1998,13.6,13,7,7,6,0,8,13,61.5,5,17,10,7,21,34,96,1
GER-Bundesliga,2425,Augsburg,Chrislain Matsima,FRA,DF,23-009,2002,28.3,31,20,19,11,1,17,26,65.4,9,48,29,19,52,83,163,0
GER-Bundesliga,2425,Augsburg,Dimitris Giannoulis,GRE,DF,29-219,1995,29.4,47,32,27,16,4,26,44,59.1,18,49,11,38,47,94,75,0
GER-Bundesliga,2425,Augsburg,Elvis Rexhbeçaj,KVX,MF,27-204,1997,19.8,27,19,9,14,4,15,35,42.9,20,40,9,31,16,43,22,1
GER-Bundesliga,2425,Augsburg,Finn Dahmen,GER,GK,27-058,1998,19.0,1,0,1,0,0,1,2,50.0,1,0,0,0,0,1,9,0
GER-Bundesliga,2425,Augsburg,Frank Onyeka,NGA,MF,27-143,1998,28.7,58,45,22,28,8,22,40,55.0,18,36,9,27,36,94,36,2
GER-Bundesliga,2425,Augsburg,Fredrik Jensen,FIN,MF,27-257,1997,8.5,7,7,1,3,3,4,5,80.0,1,10,1,9,4,11,17,0
GER-Bundesliga,2425,Augsburg,Henri Koudossou,GER,DF,25-263,1999,8.3,18,10,6,11,1,11,19,57.9,8,8,2,6,15,33,37,0
GER-Bundesliga,2425,Augsburg,Jeffrey Gouweleeuw,NED,DF,33-318,1991,32.7,50,28,25,21,4,27,40,67.5,13,34,15,19,35,85,183,0
GER-Bundesliga,2425,Augsburg,Keven Schlotterbeck,GER,DF,28-026,1997,14.4,19,17,9,9,1,12,16,75.0,4,13,6,7,15,34,73,1
GER-Bundesliga,2425,Augsburg,Kristijan Jakić,CRO,MF,28-010,1997,25.6,46,23,20,19,7,22,43,51.2,21,42,9,33,28,74,50,1
GER-Bundesliga,2425,Augsburg,Mads Pedersen,DEN,DF,28-265,1996,2.6,8,7,5,2,1,4,5,80.0,1,4,0,4,2,10,6,0
GER-Bundesliga,2425,Augsburg,Marius Wolf,GER,DF,29-362,1995,23.8,27,16,13,11,3,16,43,37.2,27,29,5,24,24,51,51,1
GER-Bundesliga,2425,Augsburg,Maximilian Bauer,GER,DF,25-104,2000,7.3,14,8,5,7,2,9,14,64.3,5,10,4,6,6,20,35,1
GER-Bundesliga,2425,Augsburg,Mergim Berisha,GER,FW,27-013,1998,0.4,1,0,0,1,0,1,1,100.0,0,2,1,1,0,1,0,0
GER-Bundesliga,2425,Augsburg,Mert Kömür,GER,MF,19-311,2005,7.3,3,2,2,0,1,0,3,0.0,3,9,3,6,3,6,7,1
GER-Bundesliga,2425,Augsburg,Nediljko Labrović,CRO,GK,25-226,1999,15.0,0,0,0,0,0,0,0,,0,0,0,0,0,0,12,1
GER-Bundesliga,2425,Augsburg,Niklas Dorsch,GER,MF,27-129,1998,0.4,0,0,0,0,0,0,0,,0,1,0,1,0,0,0,0
GER-Bundesliga,2425,Augsburg,Noahkai Banks,USA,DF,18-174,2006,3.1,11,5,6,4,1,3,7,42.9,4,4,1,3,5,16,28,0
GER-Bundesliga,2425,Augsburg,Phillip Tietz,GER,FW,27-319,1997,18.7,11,6,2,7,2,5,8,62.5,3,10,1,9,5,16,26,1
GER-Bundesliga,2425,Augsburg,Robert Gumny,POL,DF,26-354,1998,3.0,3,3,1,2,0,2,6,33.3,4,2,0,2,1,4,6,0
GER-Bundesliga,2425,Augsburg,Ruben Vargas,SUI,"MF,FW",26-292,1998,3.4,2,1,1,1,0,1,4,25.0,3,1,0,1,2,4,1,1
GER-Bundesliga,2425,Augsburg,Samuel Essende,COD,FW,27-121,1998,18.2,7,6,1,3,3,3,4,75.0,1,13,2,11,0,7,11,1
GER-Bundesliga,2425,Augsburg,Steve Mounié,BEN,"FW,MF",30-237,1994,3.9,4,4,0,1,3,0,1,0.0,1,1,1,0,1,5,5,1
GER-Bundesliga,2425,Augsburg,Tim Breithaupt,GER,MF,23-106,2002,1.3,1,1,0,1,0,0,4,0.0,4,1,0,1,2,3,0,0
GER-Bundesliga,2425,Augsburg,Yusuf Kabadayı,GER,"FW,MF",21-111,2004,0.8,1,0,0,1,0,0,0,,0,1,0,1,0,1,0,0
GER-Bundesliga,2425,Bayern Munich,Adam Aznou,MAR,DF,18-356,2006,0.2,0,0,0,0,0,0,0,,0,0,0,0,0,0,1,0
GER-Bundesliga,2425,Bayern Munich,Aleksandar Pavlovic,GER,MF,21-021,2004,16.1,38,21,13,15,10,22,32,68.8,10,18,3,15,5,43,14,0
GER-Bundesliga,2425,Bayern Munich,Alphonso Davies,CAN,DF,24-203,2000,17.3,30,17,7,17,6,17,26,65.4,9,14,1,13,13,43,22,2
GER-Bundesliga,2425,Bayern Munich,Arijon Ibrahimović,GER,FW,19-164,2005,0.0,0,0,0,0,0,0,0,,0,0,0,0,0,0,0,0
GER-Bundesliga,2425,Bayern Munich,Daniel Peretz,ISR,GK,24-318,2000,3.0,0,0,0,0,0,0,1,0.0,1,0,0,0,0,0,2,0
GER-Bundesliga,2425,Bayern Munich,Dayot Upamecano,FRA,DF,26-209,1998,19.5,36,22,18,16,2,16,29,55.2,13,17,7,10,34,70,45,1
GER-Bundesliga,2425,Bayern Munich,Eric Dier,ENG,DF,31-129,1994,16.3,19,11,8,9,2,13,20,65.0,7,19,8,11,20,39,77,1
GER-Bundesliga,2425,Bayern Munich,Gabriel Vidovic,CRO,MF,21-174,2003,0.3,0,0,0,0,0,0,0,,0,2,0,2,0,0,0,0
GER-Bundesliga,2425,Bayern Munich,Harry Kane,ENG,FW,31-300,1993,26.5,13,11,3,8,2,2,6,33.3,4,16,2,14,2,15,16,0
GER-Bundesliga,2425,Bayern Munich,Hiroki Ito,JPN,DF,26-012,1999,2.8,2,0,1,1,0,1,1,100.0,0,3,2,1,6,8,15,1
GER-Bundesliga,2425,Bayern Munich,Jamal Musiala,GER,MF,22-087,2003,20.0,36,21,7,16,13,12,29,41.4,17,30,0,30,8,44,5,1
GER-Bundesliga,2425,Bayern Munich,Jonah Kusi-Asare,SWE,FW,17-324,2007,0.0,1,0,0,0,1,0,0,,0,0,0,0,0,1,0,0
GER-Bundesliga,2425,Bayern Munich,Jonas Urbig,GER,GK,21-289,2003,8.0,0,0,0,0,0,0,0,,0,0,0,0,0,0,9,2
GER-Bundesliga,2425,Bayern Munich,Joshua Kimmich,GER,MF,30-105,1995,31.6,47,29,11,29,7,30,50,60.0,20,23,3,20,25,72,34,3
GER-Bundesliga,2425,Bayern Munich,Josip Stanišić,CRO,DF,25-052,2000,9.7,13,11,6,4,3,7,15,46.7,8,10,6,4,6,19,29,1
GER-Bundesliga,2425,Bayern Munich,João Palhinha,POR,MF,29-319,1995,7.5,20,14,6,11,3,11,16,68.8,5,13,1,12,4,24,9,1
GER-Bundesliga,2425,Bayern Munich,Kim Min-jae,KOR,DF,28-190,1996,25.4,35,20,18,13,4,11,21,52.4,10,23,10,13,37,72,91,4
GER-Bundesliga,2425,Bayern Munich,Kingsley Coman,FRA,FW,28-345,1996,14.2,17,12,6,6,5,8,12,66.7,4,12,0,12,8,25,15,0
GER-Bundesliga,2425,Bayern Munich,Konrad Laimer,AUT,DF,27-362,1997,18.9,49,27,19,22,8,23,48,47.9,25,24,1,23,8,57,24,1
GER-Bundesliga,2425,Bayern Munich,Leon Goretzka,GER,"MF,DF",30-107,1995,14.7,21,11,5,12,4,10,20,50.0,10,27,7,20,20,41,25,1
GER-Bundesliga,2425,Bayern Munich,Leroy Sané,GER,FW,29-133,1996,18.2,23,15,4,8,11,12,23,52.2,11,8,0,8,7,30,3,0
GER-Bundesliga,2425,Bayern Munich,Manuel Neuer,GER,GK,39-058,1986,22.0,1,0,1,0,0,1,1,100.0,0,0,0,0,0,1,9,1
GER-Bundesliga,2425,Bayern Munich,Mathys Tel,FRA,"FW,MF",20-027,2005,2.8,2,2,0,2,0,0,0,,0,0,0,0,1,3,1,0
GER-Bundesliga,2425,Bayern Munich,Michael Olise,FRA,"FW,MF",23-163,2001,25.9,36,23,10,21,5,17,38,44.7,21,23,1,22,8,44,16,2
GER-Bundesliga,2425,Bayern Munich,Raphaël Guerreiro,POR,"DF,MF",31-153,1993,17.5,19,12,9,7,3,12,16,75.0,4,9,0,9,10,29,19,1
GER-Bundesliga,2425,Bayern Munich,Sacha Boey,FRA,DF,24-253,2000,6.6,20,5,6,6,8,13,18,72.2,5,6,0,6,2,22,14,0
GER-Bundesliga,2425,Bayern Munich,Serge Gnabry,GER,"FW,MF",29-314,1995,13.8,20,11,6,7,7,8,12,66.7,4,11,0,11,6,26,9,0
GER-Bundesliga,2425,Bayern Munich,Sven Ulreich,GER,GK,36-294,1988,1.0,0,0,0,0,0,0,0,,0,0,0,0,0,0,0,0
GER-Bundesliga,2425,Bayern Munich,Thomas Müller,GER,"MF,FW",35-253,1989,13.6,8,5,2,3,3,4,16,25.0,12,10,0,10,2,10,14,0
GER-Bundesliga,2425,Bochum,Aliou Badara Baldé,GUI,"MF,FW",22-163,2002,1.0,1,1,1,0,0,0,0,,0,2,0,2,0,1,0,0
GER-Bundesliga,2425,Bochum,Anthony Losilla,FRA,MF,39-075,1986,12.6,30,16,15,12,3,17,33,51.5,16,22,7,15,18,48,27,1
GER-Bundesliga,2425,Bochum,Bernardo,BRA,DF,30-010,1995,19.8,46,28,32,13,1,27,37,73.0,10,38,17,21,26,72,103,4
GER-Bundesliga,2425,Bochum,Cristian Gamboa,CRC,DF,35-212,1989,2.5,8,3,5,3,0,3,9,33.3,6,2,0,2,2,10,8,0
GER-Bundesliga,2425,Bochum,Dani de Wit,NED,"MF,FW",27-116,1998,12.8,29,17,11,15,3,18,31,58.1,13,17,4,13,12,41,23,1
GER-Bundesliga,2425,Bochum,Erhan Mašović,SRB,DF,26-183,1998,10.1,14,10,10,4,0,13,28,46.4,15,17,11,6,12,26,55,0
GER-Bundesliga,2425,Bochum,Felix Passlack,GER,"DF,MF",26-360,1998,25.9,53,23,32,13,8,30,55,54.5,25,42,11,31,18,71,63,1
GER-Bundesliga,2425,Bochum,Gerrit Holtmann,PHI,"DF,FW",30-060,1995,12.6,24,19,14,8,2,12,24,50.0,12,18,5,13,16,40,15,0
GER-Bundesliga,2425,Bochum,Giorgos Masouras,GRE,"FW,MF",31-143,1994,11.7,18,10,6,7,5,7,16,43.8,9,9,1,8,4,22,3,1
GER-Bundesliga,2425,Bochum,Ibrahima Sissoko,MLI,MF,27-209,1997,29.0,66,44,30,31,5,24,45,53.3,21,39,11,28,36,102,61,0
GER-Bundesliga,2425,Bochum,Ivan Ordets,UKR,DF,32-320,1992,20.7,18,8,13,5,0,10,13,76.9,3,29,16,13,41,59,139,3
GER-Bundesliga,2425,Bochum,Jakov Medić,CRO,DF,26-259,1998,17.8,13,11,9,3,1,8,18,44.4,10,32,21,11,22,35,111,4
GER-Bundesliga,2425,Bochum,Kacper Koscierski,GER,DF,17-335,2007,0.1,0,0,0,0,0,0,0,,0,0,0,0,0,0,0,0
GER-Bundesliga,2425,Bochum,Koji Miyoshi,JPN,"FW,MF",28-059,1997,5.2,8,5,2,1,5,4,9,44.4,5,10,1,9,2,10,2,0
GER-Bundesliga,2425,Bochum,Lukas Daschner,GER,"MF,FW",26-235,1998,4.6,4,2,1,2,1,2,9,22.2,7,5,0,5,0,4,5,0
GER-Bundesliga,2425,Bochum,Mats Pannewig,GER,MF,20-208,2004,3.0,10,6,7,3,0,3,12,25.0,9,8,1,7,2,12,8,0
GER-Bundesliga,2425,Bochum,Matúš Bero,SVK,MF,29-260,1995,28.5,65,35,33,21,11,29,60,48.3,31,37,9,28,17,82,35,1
GER-Bundesliga,2425,Bochum,Maximilian Wittek,GER,DF,29-276,1995,30.1,65,42,40,19,6,38,54,70.4,16,54,8,46,27,92,89,3
GER-Bundesliga,2425,Bochum,Moritz Broschinski,GER,"FW,MF",24-243,2000,15.4,19,14,6,6,7,6,15,40.0,9,18,0,18,1,20,18,0
GER-Bundesliga,2425,Bochum,Moritz-Broni Kwarteng,GHA,"MF,FW",27-026,1998,1.9,4,3,1,1,2,1,2,50.0,1,0,0,0,0,4,1,0
GER-Bundesliga,2425,Bochum,Myron Boadu,NED,FW,24-130,2001,11.6,2,1,0,0,2,1,5,20.0,4,3,0,3,1,3,4,0
GER-Bundesliga,2425,Bochum,Patrick Drewes,GER,GK,32-109,1993,21.0,0,0,0,0,0,0,1,0.0,1,1,0,1,0,0,11,1
GER-Bundesliga,2425,Bochum,Philipp Hofmann,GER,FW,32-055,1993,25.3,17,12,4,6,7,8,15,53.3,7,14,1,13,4,21,33,0
GER-Bundesliga,2425,Bochum,Samuel Bamba,GER,"FW,MF",21-100,2004,0.3,1,1,1,0,0,0,0,,0,0,0,0,0,1,0,0
GER-Bundesliga,2425,Bochum,Tim Oermann,GER,DF,21-230,2003,24.6,50,31,25,21,4,26,43,60.5,17,32,16,16,22,72,64,0
GER-Bundesliga,2425,Bochum,Timo Horn,GER,GK,32-012,1993,13.0,0,0,0,0,0,0,0,,0,0,0,0,0,0,9,2
GER-Bundesliga,2425,Bochum,Tom Krauß,GER,MF,23-336,2001,12.0,35,18,20,13,2,19,38,50.0,19,26,2,24,11,46,19,1
GER-Bundesliga,2425,Dortmund,Alexander Meyer,GER,GK,34-041,1991,2.0,0,0,0,0,0,0,0,,0,0,0,0,0,0,0,0
GER-Bundesliga,2425,Dortmund,Almugera Kabar,GER,DF,18-352,2006,1.5,5,3,2,2,1,3,3,100.0,0,1,0,1,1,6,4,0
GER-Bundesliga,2425,Dortmund,Ayman Azhil,MAR,MF,24-044,2001,0.3,1,1,1,0,0,0,0,,0,0,0,0,0,1,0,0
GER-Bundesliga,2425,Dortmund,Carney Chukwuemeka,ENG,MF,21-216,2003,2.8,7,5,3,2,2,1,1,100.0,0,5,0,5,1,8,1,0
GER-Bundesliga,2425,Dortmund,Cole Campbell,USA,"MF,FW",19-093,2006,0.2,0,0,0,0,0,0,0,,0,0,0,0,0,0,1,0
GER-Bundesliga,2425,Dortmund,Daniel Svensson,SWE,"DF,FW",23-101,2002,8.7,15,11,5,6,4,7,11,63.6,4,10,4,6,5,20,30,0
GER-Bundesliga,2425,Dortmund,Donyell Malen,NED,"FW,MF",26-135,1999,6.8,0,0,0,0,0,0,2,0.0,2,2,0,2,3,3,6,0
GER-Bundesliga,2425,Dortmund,Emre Can,GER,"DF,MF",31-132,1994,23.4,50,28,30,16,4,18,36,50.0,18,31,17,14,20,70,89,3
GER-Bundesliga,2425,Dortmund,Felix Nmecha,GER,MF,24-226,2000,16.8,34,22,6,19,9,12,22,54.5,10,20,5,15,23,57,30,1
GER-Bundesliga,2425,Dortmund,Gio Reyna,USA,MF,22-192,2002,3.9,7,0,3,0,4,4,5,80.0,1,3,1,2,0,7,9,0
GER-Bundesliga,2425,Dortmund,Gregor Kobel,SUI,GK,27-169,1997,32.0,0,0,0,0,0,0,0,,0,0,0,0,1,1,23,3
GER-Bundesliga,2425,Dortmund,Jamie Gittens,ENG,"FW,MF",20-289,2004,19.7,31,19,12,12,7,14,18,77.8,4,16,0,16,10,41,4,0
GER-Bundesliga,2425,Dortmund,Julian Brandt,GER,MF,29-022,1996,25.6,26,11,13,8,5,15,43,34.9,28,17,0,17,14,40,13,1
GER-Bundesliga,2425,Dortmund,Julian Ryerson,NOR,DF,27-188,1997,25.1,46,30,26,13,7,25,44,56.8,19,29,2,27,22,68,26,1
GER-Bundesliga,2425,Dortmund,Julien Duranville,BEL,"FW,MF",19-019,2006,3.1,3,0,0,3,0,1,2,50.0,1,1,0,1,0,3,3,0
GER-Bundesliga,2425,Dortmund,Karim Adeyemi,GER,"FW,MF",23-126,2002,15.9,20,14,6,6,8,8,20,40.0,12,14,1,13,7,27,5,0
GER-Bundesliga,2425,Dortmund,Kjell-Arik Wätjen,GER,MF,19-097,2006,0.2,0,0,0,0,0,0,0,,0,0,0,0,0,0,2,0
GER-Bundesliga,2425,Dortmund,Marcel Sabitzer,AUT,MF,31-068,1994,18.0,29,19,7,15,7,16,27,59.3,11,19,6,13,10,39,29,1
GER-Bundesliga,2425,Dortmund,Maximilian Beier,GER,"FW,MF",22-219,2002,17.7,25,16,8,11,6,12,31,38.7,19,15,1,14,7,32,14,1
GER-Bundesliga,2425,Dortmund,Nico Schlotterbeck,GER,DF,25-174,1999,22.0,38,24,21,16,1,27,45,60.0,18,31,15,16,22,60,79,1
GER-Bundesliga,2425,Dortmund,Niklas Süle,GER,DF,29-263,1995,11.7,14,12,9,5,0,10,14,71.4,4,11,6,5,4,18,46,1
GER-Bundesliga,2425,Dortmund,Pascal Groß,GER,"MF,DF",33-343,1991,25.9,44,28,11,26,7,15,51,29.4,36,46,13,33,9,53,30,1
GER-Bundesliga,2425,Dortmund,Ramy Bensebaini,ALG,DF,30-038,1995,22.5,51,25,25,18,8,33,51,64.7,18,42,9,33,33,84,86,1
GER-Bundesliga,2425,Dortmund,Salih Özcan,TUR,MF,27-133,1998,4.3,11,7,6,4,1,7,13,53.8,6,7,0,7,11,22,10,0
GER-Bundesliga,2425,Dortmund,Serhou Guirassy,GUI,FW,29-073,1996,28.9,7,6,2,2,3,2,5,40.0,3,10,3,7,4,11,38,0
GER-Bundesliga,2425,Dortmund,Waldemar Anton,GER,DF,28-308,1996,21.7,34,21,18,10,6,17,23,73.9,6,33,16,17,30,64,112,1
GER-Bundesliga,2425,Dortmund,Yan Couto,BRA,"DF,FW",22-355,2002,9.9,24,16,17,2,5,14,25,56.0,11,12,1,11,10,34,32,2
GER-Bundesliga,2425,Dortmund,Yannik Lührs,GER,DF,21-257,2003,1.4,1,1,1,0,0,0,0,,0,0,0,0,2,3,4,0
GER-Bundesliga,2425,Eint Frankfurt,Ansgar Knauff,GER,"MF,DF",23-134,2002,17.7,41,22,18,16,7,12,26,46.2,14,23,4,19,12,53,24,0
GER-Bundesliga,2425,Eint Frankfurt,Arthur Theate,BEL,DF,24-364,2000,30.0,36,25,19,16,1,22,44,50.0,22,42,19,23,39,75,170,3
GER-Bundesliga,2425,Eint Frankfurt,Aurele Amenda,SUI,DF,21-297,2003,1.1,1,0,1,0,0,0,0,,0,2,2,0,2,3,11,0
GER-Bundesliga,2425,Eint Frankfurt,Can Uzun,TUR,"MF,FW",19-194,2005,7.5,10,4,1,4,5,5,10,50.0,5,9,0,9,1,11,3,0
GER-Bundesliga,2425,Eint Frankfurt,Ellyes Skhiri,TUN,MF,30-014,1995,24.8,40,22,15,21,4,18,44,40.9,26,30,7,23,31,71,45,4
GER-Bundesliga,2425,Eint Frankfurt,Elye Wahi,FRA,"FW,MF",22-142,2003,2.2,0,0,0,0,0,0,1,0.0,1,1,0,1,0,0,1,0
GER-Bundesliga,2425,Eint Frankfurt,Fares Chaïbi,ALG,"MF,FW",22-177,2002,11.3,13,9,4,5,4,7,20,35.0,13,10,0,10,10,23,32,1
GER-Bundesliga,2425,Eint Frankfurt,Hugo Ekitike,FRA,FW,22-338,2002,28.5,16,12,3,8,5,4,12,33.3,8,13,1,12,7,23,24,0
GER-Bundesliga,2425,Eint Frankfurt,Hugo Larsson,SWE,MF,20-331,2004,26.6,47,27,17,25,5,21,42,50.0,21,42,11,31,30,77,35,1
GER-Bundesliga,2425,Eint Frankfurt,Igor Matanovic,CRO,FW,22-054,2003,3.5,2,0,0,2,0,0,1,0.0,1,3,0,3,1,3,9,0
GER-Bundesliga,2425,Eint Frankfurt,Jean Mattéo Bahoya,FRA,"MF,FW",20-017,2005,10.2,29,18,11,13,5,16,26,61.5,10,14,2,12,4,33,10,1
GER-Bundesliga,2425,Eint Frankfurt,Junior Dina Ebimbe,FRA,"MF,FW",24-184,2000,3.3,3,2,1,2,0,1,3,33.3,2,4,0,4,7,10,6,0
GER-Bundesliga,2425,Eint Frankfurt,Kauã Santos,BRA,GK,22-043,2003,8.5,0,0,0,0,0,0,0,,0,0,0,0,0,0,10,2
GER-Bundesliga,2425,Eint Frankfurt,Kevin Trapp,GER,GK,34-320,1990,25.5,0,0,0,0,0,0,0,,0,0,0,0,0,0,13,3
GER-Bundesliga,2425,Eint Frankfurt,Mahmoud Dahoud,GER,MF,29-143,1996,4.0,9,4,4,5,0,4,6,66.7,2,5,1,4,2,11,5,0
GER-Bundesliga,2425,Eint Frankfurt,Mario Götze,GER,"MF,FW",32-355,1992,17.1,41,28,18,20,3,15,36,41.7,21,15,1,14,7,48,8,0
GER-Bundesliga,2425,Eint Frankfurt,Michy Batshuayi,BEL,FW,31-234,1993,3.3,1,1,1,0,0,1,1,100.0,0,2,0,2,1,2,0,0
GER-Bundesliga,2425,Eint Frankfurt,Nathaniel Brown,GER,"DF,MF",21-342,2003,21.6,71,42,39,18,14,44,55,80.0,11,30,0,30,15,86,55,1
GER-Bundesliga,2425,Eint Frankfurt,Niels Nkounkou,FRA,"DF,MF",24-204,2000,4.2,13,10,7,3,3,4,7,57.1,3,5,2,3,7,20,15,0
GER-Bundesliga,2425,Eint Frankfurt,Nnamdi Collins,GER,DF,21-134,2004,16.5,33,24,24,7,2,17,22,77.3,5,22,11,11,16,49,74,3
GER-Bundesliga,2425,Eint Frankfurt,Omar Marmoush,EGY,FW,26-106,1999,16.1,12,8,0,3,9,3,7,42.9,4,7,1,6,2,14,2,0
GER-Bundesliga,2425,Eint Frankfurt,Oscar Højlund,DEN,MF,20-140,2005,8.0,21,12,8,9,4,8,16,50.0,8,15,7,8,5,26,11,1
GER-Bundesliga,2425,Eint Frankfurt,Rasmus Kristensen,DEN,DF,27-317,1997,27.9,59,33,37,17,5,40,67,59.7,27,50,13,37,20,79,97,1
GER-Bundesliga,2425,Eint Frankfurt,Robin Koch,GER,DF,28-311,1996,28.7,24,11,14,8,2,10,22,45.5,12,39,25,14,25,49,197,4
GER-Bundesliga,2425,Eint Frankfurt,Timothy Chandler,USA,DF,35-056,1990,0.3,0,0,0,0,0,0,0,,0,0,0,0,3,3,2,0
GER-Bundesliga,2425,Eint Frankfurt,Tuta,BRA,"DF,MF",25-324,1999,25.3,44,27,25,17,2,28,40,70.0,12,42,21,21,40,84,135,1
GER-Bundesliga,2425,Freiburg,Christian Günter,GER,DF,32-085,1993,25.7,23,21,12,8,3,16,29,55.2,13,24,10,14,8,31,50,1
GER-Bundesliga,2425,Freiburg,Eren Dinkçi,GER,"MF,FW",23-162,2001,13.3,21,13,8,8,5,7,23,30.4,16,22,2,20,7,28,7,0
GER-Bundesliga,2425,Freiburg,Florent Muslija,KVX,"FW,MF",26-322,1998,1.9,5,4,3,1,1,2,2,100.0,0,0,0,0,1,6,1,0
GER-Bundesliga,2425,Freiburg,Florian Müller,GER,GK,27-192,1997,8.4,0,0,0,0,0,0,0,,0,0,0,0,0,0,3,0
GER-Bundesliga,2425,Freiburg,Ifechukwu Ogbus,SUI,DF,19-158,2005,0.2,1,1,0,0,1,0,1,0.0,1,0,0,0,1,2,2,0
GER-Bundesliga,2425,Freiburg,Jan-Niklas Beste,GER,"FW,MF",26-140,1999,2.4,2,1,0,1,1,1,7,14.3,6,3,0,3,1,3,7,0
GER-Bundesliga,2425,Freiburg,Johan Manzambi,SUI,"FW,MF",19-222,2005,3.7,8,2,1,3,4,1,4,25.0,3,6,0,6,4,12,7,0
GER-Bundesliga,2425,Freiburg,Jordy Makengo,FRA,DF,23-294,2001,8.3,16,9,10,5,1,10,16,62.5,6,8,3,5,7,23,29,0
GER-Bundesliga,2425,Freiburg,Junior Adamu,AUT,FW,23-352,2001,17.2,9,3,3,3,3,3,11,27.3,8,14,0,14,12,21,20,0
GER-Bundesliga,2425,Freiburg,Kiliann Sildillia,FRA,DF,23-008,2002,8.9,17,10,8,6,3,7,13,53.8,6,16,5,11,11,28,38,0
GER-Bundesliga,2425,Freiburg,Lucas Höler,GER,"FW,MF",30-318,1994,20.7,37,24,18,15,4,9,24,37.5,15,29,7,22,7,44,36,0
GER-Bundesliga,2425,Freiburg,Lukas Kübler,GER,DF,32-267,1992,20.5,40,21,17,20,3,27,48,56.3,21,32,13,19,53,93,61,3
GER-Bundesliga,2425,Freiburg,Matthias Ginter,GER,DF,31-125,1994,28.5,30,17,15,11,4,15,28,53.6,13,35,23,12,19,49,146,5
GER-Bundesliga,2425,Freiburg,Max Rosenfelder,GER,DF,22-103,2003,13.9,27,17,17,10,0,14,19,73.7,5,17,9,8,7,34,65,0
GER-Bundesliga,2425,Freiburg,Maximilian Eggestein,GER,MF,28-167,1996,31.6,57,32,21,26,10,24,43,55.8,19,37,10,27,39,96,54,1
GER-Bundesliga,2425,Freiburg,Maximilian Philipp,GER,"MF,FW",31-084,1994,0.2,0,0,0,0,0,0,0,,0,0,0,0,0,0,0,0
GER-Bundesliga,2425,Freiburg,Merlin Röhl,GER,"MF,FW",22-323,2002,10.7,16,10,4,10,2,9,11,81.8,2,9,1,8,6,22,2,0
GER-Bundesliga,2425,Freiburg,Michael Gregoritsch,AUT,FW,31-036,1994,7.1,4,2,1,0,3,1,5,20.0,4,2,1,1,1,5,10,0
GER-Bundesliga,2425,Freiburg,Nicolas Höfler,GER,MF,35-076,1990,8.8,33,23,13,18,2,20,31,64.5,11,7,1,6,14,47,28,1
GER-Bundesliga,2425,Freiburg,Noah Atubolu,GER,GK,22-364,2002,25.6,0,0,0,0,0,0,0,,0,0,0,0,0,0,13,4
GER-Bundesliga,2425,Freiburg,Noah Weißhaupt,GER,FW,23-246,2001,0.9,0,0,0,0,0,0,1,0.0,1,0,0,0,0,0,1,0
GER-Bundesliga,2425,Freiburg,Patrick Osterhage,GER,MF,25-112,2000,25.2,45,29,16,27,2,14,30,46.7,16,27,3,24,18,63,37,0
GER-Bundesliga,2425,Freiburg,Philipp Lienhart,AUT,DF,28-317,1996,30.8,22,13,12,10,0,15,31,48.4,16,31,20,11,36,58,124,3
GER-Bundesliga,2425,Freiburg,Ritsu Doan,JPN,"FW,MF",26-342,1998,31.8,66,42,33,26,7,25,46,54.3,21,57,2,55,14,80,47,1
GER-Bundesliga,2425,Freiburg,Roland Sallai,HUN,"FW,MF",28-002,1997,0.5,2,1,1,1,0,0,0,,0,0,0,0,1,3,0,0
GER-Bundesliga,2425,Freiburg,Vincenzo Grifo,ITA,"FW,MF",32-047,1993,27.0,30,22,12,13,5,15,34,44.1,19,24,2,22,9,39,23,2
GER-Bundesliga,2425,Gladbach,Alassane Pléa,FRA,"MF,FW",32-075,1993,21.1,7,3,0,2,5,4,13,30.8,9,11,0,11,2,9,7,1
GER-Bundesliga,2425,Gladbach,Fabio Chiarodia,ITA,DF,19-353,2005,4.2,10,4,6,4,0,4,6,66.7,2,8,3,5,9,19,53,1
GER-Bundesliga,2425,Gladbach,Florian Neuhaus,GER,MF,28-069,1997,4.2,10,3,7,3,0,7,17,41.2,10,9,2,7,6,16,5,1
GER-Bundesliga,2425,Gladbach,Franck Honorat,FRA,FW,28-286,1996,16.0,17,7,10,4,3,2,8,25.0,6,9,1,8,5,22,28,1
GER-Bundesliga,2425,Gladbach,Grant Ranos,ARM,FW,21-308,2003,0.2,1,0,0,1,0,0,1,0.0,1,2,0,2,0,1,0,0
GER-Bundesliga,2425,Gladbach,Joe Scally,USA,DF,22-144,2002,28.6,45,32,25,18,2,27,46,58.7,19,35,11,24,16,61,86,2
GER-Bundesliga,2425,Gladbach,Jonas Omlin,SUI,GK,31-134,1994,10.9,0,0,0,0,0,0,1,0.0,1,0,0,0,0,0,5,1
GER-Bundesliga,2425,Gladbach,Julian Weigl,GER,MF,29-258,1995,32.0,53,25,24,24,5,28,46,60.9,18,54,27,27,48,101,86,3
GER-Bundesliga,2425,Gladbach,Kevin Stöger,AUT,MF,31-270,1993,17.2,37,21,23,10,4,16,39,41.0,23,24,3,21,16,53,26,3
GER-Bundesliga,2425,Gladbach,Ko Itakura,JPN,DF,28-117,1997,31.0,40,29,23,16,1,21,34,61.8,13,41,22,19,28,68,171,0
GER-Bundesliga,2425,Gladbach,Luca Netz,GER,DF,22-009,2003,10.8,24,14,14,8,2,13,19,68.4,6,17,4,13,10,34,36,0
GER-Bundesliga,2425,Gladbach,Lukas Ullrich,GER,DF,21-069,2004,21.1,25,16,18,6,1,15,42,35.7,27,26,9,17,23,48,74,1
GER-Bundesliga,2425,Gladbach,Marvin Friedrich,GER,DF,29-162,1995,11.0,15,9,12,3,0,9,16,56.3,7,16,12,4,5,20,57,0
GER-Bundesliga,2425,Gladbach,Moritz Nicolas,GER,GK,27-215,1997,18.2,0,0,0,0,0,0,0,,0,1,0,1,1,1,8,1
GER-Bundesliga,2425,Gladbach,Nathan N'Goumou,CMR,FW,25-071,2000,9.2,17,11,11,4,2,6,11,54.5,5,8,2,6,4,21,16,0
GER-Bundesliga,2425,Gladbach,Nico Elvedi,SUI,DF,28-236,1996,23.7,38,23,28,6,4,17,23,73.9,6,35,27,8,30,68,163,0
GER-Bundesliga,2425,Gladbach,Noah Pesch,CRO,FW,20-006,2005,0.1,1,0,0,0,1,0,0,,0,0,0,0,0,1,0,0
GER-Bundesliga,2425,Gladbach,Philipp Sander,GER,MF,27-092,1998,15.6,33,17,16,15,2,10,23,43.5,13,16,7,9,23,56,44,3
GER-Bundesliga,2425,Gladbach,Robin Hack,GER,"FW,MF",26-270,1998,24.1,22,17,11,8,3,12,28,42.9,16,30,2,28,9,31,28,0
GER-Bundesliga,2425,Gladbach,Rocco Reitz,GER,MF,22-360,2002,20.3,52,24,24,24,4,24,43,55.8,19,39,16,23,53,105,59,2
GER-Bundesliga,2425,Gladbach,Shiō Fukuda,JPN,FW,21-046,2004,0.7,0,0,0,0,0,0,0,,0,1,0,1,0,0,0,0
GER-Bundesliga,2425,Gladbach,Stefan Lainer,AUT,DF,32-270,1992,8.4,22,13,16,5,1,12,14,85.7,2,12,6,6,12,34,30,0
GER-Bundesliga,2425,Gladbach,Tiago Cardoso,LUX,GK,19-047,2006,4.2,1,0,1,0,0,1,1,100.0,0,0,0,0,0,1,2,2
GER-Bundesliga,2425,Gladbach,Tim Kleindienst,GER,FW,29-266,1995,30.4,30,15,6,15,9,10,35,28.6,25,45,9,36,12,42,66,1
GER-Bundesliga,2425,Gladbach,Tobias Sippel,GER,GK,37-063,1988,0.7,0,0,0,0,0,0,0,,0,0,0,0,0,0,0,0
GER-Bundesliga,2425,Gladbach,Tomáš Čvančara,CZE,FW,24-284,2000,9.2,4,1,3,1,0,2,7,28.6,5,6,3,3,5,9,17,0
GER-Bundesliga,2425,Heidenheim,Adrian Beck,GER,"MF,FW",27-349,1997,17.8,36,17,18,12,6,12,35,34.3,23,31,2,29,9,45,17,0
GER-Bundesliga,2425,Heidenheim,Benedikt Gimber,GER,DF,28-094,1997,29.7,72,46,48,23,1,38,63,60.3,25,53,19,34,31,103,131,1
GER-Bundesliga,2425,Heidenheim,Budu Zivzivadze,GEO,FW,31-075,1994,10.6,17,11,1,9,7,4,8,50.0,4,9,0,9,3,20,7,0
GER-Bundesliga,2425,Heidenheim,Denis Thomalla,GER,MF,32-281,1992,0.0,0,0,0,0,0,0,0,,0,0,0,0,0,0,0,0
GER-Bundesliga,2425,Heidenheim,Frank Feller,GER,GK,21-137,2004,1.3,0,0,0,0,0,0,0,,0,0,0,0,0,0,1,0
GER-Bundesliga,2425,Heidenheim,Frans Krätzig,GER,"DF,MF",22-130,2003,13.5,32,18,14,12,6,12,21,57.1,9,12,1,11,17,49,15,0
GER-Bundesliga,2425,Heidenheim,Jan Schöppner,GER,MF,25-346,1999,29.8,56,30,19,27,10,20,58,34.5,38,38,6,32,43,99,95,1
GER-Bundesliga,2425,Heidenheim,Jonas Föhrenbach,GER,DF,29-118,1996,20.4,45,24,25,15,5,22,35,62.9,13,29,3,26,16,61,57,0
GER-Bundesliga,2425,Heidenheim,Julian Niehues,GER,MF,24-037,2001,1.7,3,1,3,0,0,1,5,20.0,4,1,0,1,0,3,8,0
GER-Bundesliga,2425,Heidenheim,Kevin Müller,GER,GK,34-070,1991,32.7,3,2,3,0,0,3,3,100.0,0,0,0,0,0,3,13,4
GER-Bundesliga,2425,Heidenheim,Lennard Maloney,USA,MF,25-228,1999,8.4,20,11,12,7,1,14,23,60.9,9,9,2,7,14,34,38,0
GER-Bundesliga,2425,Heidenheim,Luca Kerber,GER,"MF,DF",23-075,2002,8.7,26,16,17,8,1,16,31,51.6,15,14,4,10,5,31,25,1
GER-Bundesliga,2425,Heidenheim,Léo Scienza,BRA,"FW,MF",26-253,1998,12.8,17,12,10,5,2,7,18,38.9,11,13,1,12,5,22,9,1
GER-Bundesliga,2425,Heidenheim,Marnon Busch,GER,"DF,MF",30-167,1994,15.5,26,17,19,7,0,23,32,71.9,9,23,10,13,13,39,65,5
GER-Bundesliga,2425,Heidenheim,Marvin Pieringer,GER,"FW,MF",25-232,1999,24.5,23,13,5,12,6,5,10,50.0,5,21,2,19,8,31,32,0
GER-Bundesliga,2425,Heidenheim,Mathias Honsak,AUT,"FW,DF",28-155,1996,13.1,15,8,10,5,0,10,23,43.5,13,19,4,15,10,25,31,0
GER-Bundesliga,2425,Heidenheim,Maximilian Breunig,GER,"FW,MF",24-283,2000,3.9,4,3,1,2,1,3,6,50.0,3,9,2,7,1,5,3,0
GER-Bundesliga,2425,Heidenheim,Mikkel Kaufmann,DEN,FW,24-141,2001,4.1,6,4,1,3,2,2,5,40.0,3,5,2,3,2,8,7,0
GER-Bundesliga,2425,Heidenheim,Niklas Dorsch,GER,MF,27-129,1998,14.8,27,16,12,15,0,13,22,59.1,9,14,1,13,17,44,17,2
GER-Bundesliga,2425,Heidenheim,Norman Theuerkauf,GER,MF,38-120,1987,0.2,0,0,0,0,0,0,0,,0,0,0,0,0,0,0,0
GER-Bundesliga,2425,Heidenheim,Omar Traoré,GER,DF,27-109,1998,29.1,50,26,31,16,3,25,41,61.0,16,35,6,29,21,71,66,0
GER-Bundesliga,2425,Heidenheim,Patrick Mainka,GER,DF,30-199,1994,34.0,58,30,36,20,2,35,55,63.6,20,61,36,25,68,126,206,0
GER-Bundesliga,2425,Heidenheim,Paul Wanner,GER,"MF,FW",19-152,2005,19.7,40,27,16,21,3,15,32,46.9,17,15,0,15,4,44,20,0
GER-Bundesliga,2425,Heidenheim,Sirlord Conteh,GER,"FW,MF",28-319,1996,9.9,9,5,3,6,0,2,7,28.6,5,1,1,0,1,10,8,0
GER-Bundesliga,2425,Heidenheim,Stefan Schimmer,GER,"FW,MF",31-026,1994,2.7,2,0,1,1,0,1,2,50.0,1,1,0,1,0,2,4,0
GER-Bundesliga,2425,Heidenheim,Thomas Keller,GER,"DF,MF",25-292,1999,1.6,6,5,5,1,0,4,6,66.7,2,3,1,2,4,10,11,0
GER-Bundesliga,2425,Heidenheim,Tim Siersleben,GER,DF,25-076,2000,13.1,21,14,12,8,1,7,17,41.2,10,19,6,13,20,41,66,0
GER-Bundesliga,2425,Hoffenheim,Adam Hložek,CZE,"FW,MF",22-303,2002,20.8,22,10,7,8,7,11,20,55.0,9,13,1,12,4,26,20,0
GER-Bundesliga,2425,Hoffenheim,Alexander Prass,AUT,DF,23-363,2001,17.4,42,23,24,15,3,24,59,40.7,35,33,6,27,9,51,53,4
GER-Bundesliga,2425,Hoffenheim,Andrej Kramarić,CRO,"MF,FW",33-339,1991,30.7,15,8,5,8,2,6,11,54.5,5,16,3,13,7,22,11,1
GER-Bundesliga,2425,Hoffenheim,Anton Stach,GER,"MF,DF",26-190,1998,28.7,66,46,25,37,4,32,47,68.1,15,47,13,34,46,112,101,2
GER-Bundesliga,2425,Hoffenheim,Arthur Chaves,BRA,DF,24-115,2001,24.3,51,36,28,19,4,25,50,50.0,25,47,20,27,37,88,136,3
GER-Bundesliga,2425,Hoffenheim,Bazoumana Touré,CIV,"FW,MF",19-083,2006,6.8,12,10,2,7,3,2,8,25.0,6,4,0,4,3,15,2,0
GER-Bundesliga,2425,Hoffenheim,David Jurásek,CZE,DF,24-290,2000,6.9,6,3,3,2,1,2,5,40.0,3,5,0,5,6,12,17,0
GER-Bundesliga,2425,Hoffenheim,David Mokwa,FRA,"DF,FW",21-021,2004,0.2,1,0,1,0,0,0,0,,0,0,0,0,0,1,0,0
GER-Bundesliga,2425,Hoffenheim,Dennis Geiger,GER,"MF,FW",26-348,1998,8.2,24,11,9,13,2,12,19,63.2,7,15,2,13,7,31,6,1
GER-Bundesliga,2425,Hoffenheim,Diadie Samassékou,MLI,MF,29-133,1996,3.2,5,5,1,2,2,2,4,50.0,2,4,2,2,5,10,5,0
GER-Bundesliga,2425,Hoffenheim,Erencan Yardimci,TUR,"FW,MF",23-109,2002,3.5,4,3,1,3,0,1,2,50.0,1,2,0,2,1,5,2,0
GER-Bundesliga,2425,Hoffenheim,Finn Ole Becker,GER,MF,24-350,2000,7.4,11,5,4,6,1,1,4,25.0,3,7,3,4,10,21,20,0
GER-Bundesliga,2425,Hoffenheim,Florian Grillitsch,AUT,MF,29-290,1995,6.7,15,9,5,9,1,8,14,57.1,6,6,2,4,8,23,18,0
GER-Bundesliga,2425,Hoffenheim,Florian Micheler,AUT,MF,20-007,2005,0.4,0,0,0,0,0,0,2,0.0,2,0,0,0,0,0,0,0
GER-Bundesliga,2425,Hoffenheim,Gift Orban,NGA,FW,22-311,2002,7.6,3,1,2,1,0,1,6,16.7,5,7,0,7,0,3,3,0
GER-Bundesliga,2425,Hoffenheim,Grischa Prömel,GER,MF,30-135,1995,1.9,0,0,0,0,0,0,1,0.0,1,1,1,0,2,2,4,0
GER-Bundesliga,2425,Hoffenheim,Hannes Behrens,GER,DF,,,0.3,1,1,0,1,0,0,0,,0,1,0,1,2,3,0,0
GER-Bundesliga,2425,Hoffenheim,Haris Tabakovic,BIH,FW,30-338,1994,9.1,3,1,1,0,2,0,3,0.0,3,4,2,2,1,4,16,0
GER-Bundesliga,2425,Hoffenheim,Ihlas Bebou,TOG,MF,31-031,1994,0.1,0,0,0,0,0,0,0,,0,0,0,0,0,0,0,0
GER-Bundesliga,2425,Hoffenheim,Jacob Bruun Larsen,DEN,"FW,MF",26-247,1998,4.4,4,3,1,2,1,3,8,37.5,5,5,1,4,1,5,2,0
GER-Bundesliga,2425,Hoffenheim,Kevin Akpoguma,NGA,DF,30-035,1995,24.7,54,27,36,12,6,30,46,65.2,16,65,37,28,29,83,115,1
GER-Bundesliga,2425,Hoffenheim,Leo Skiri Østigård,NOR,DF,25-177,1999,10.3,9,7,5,4,0,4,6,66.7,2,17,9,8,9,18,111,0
GER-Bundesliga,2425,Hoffenheim,Luca Philipp,GER,GK,24-177,2000,6.0,1,0,1,0,0,1,1,100.0,0,0,0,0,0,1,1,0
GER-Bundesliga,2425,Hoffenheim,Marius Bülter,GER,"FW,DF",32-056,1993,19.2,13,10,5,6,2,9,17,52.9,8,10,3,7,4,17,14,1
GER-Bundesliga,2425,Hoffenheim,Max Moerstedt,GER,FW,,,5.0,5,5,1,3,1,1,2,50.0,1,4,0,4,0,5,5,0
GER-Bundesliga,2425,Hoffenheim,Mergim Berisha,GER,"FW,MF",27-013,1998,3.7,3,3,1,2,0,0,3,0.0,3,2,1,1,0,3,3,0
GER-Bundesliga,2425,Hoffenheim,Oliver Baumann,GER,GK,34-356,1990,28.0,2,2,2,0,0,2,4,50.0,2,0,0,0,0,2,15,2
GER-Bundesliga,2425,Hoffenheim,Paul Hennrich,GER,MF,20-079,2005,0.1,0,0,0,0,0,0,0,,0,1,1,0,0,0,0,0
GER-Bundesliga,2425,Hoffenheim,Pavel Kadeřábek,CZE,DF,33-029,1992,17.5,25,14,14,4,7,15,31,48.4,16,13,3,10,20,45,54,1
GER-Bundesliga,2425,Hoffenheim,Robin Hranáč,CZE,DF,25-115,2000,2.4,0,0,0,0,0,0,1,0.0,1,3,2,1,5,5,9,1
GER-Bundesliga,2425,Hoffenheim,Stanley N'Soki,FRA,DF,26-045,1999,14.5,22,16,13,7,2,12,23,52.2,11,22,7,15,26,48,58,3
GER-Bundesliga,2425,Hoffenheim,Tim Drexler,GER,DF,20-079,2005,4.0,17,7,11,6,0,9,12,75.0,3,6,4,2,1,18,9,1
GER-Bundesliga,2425,Hoffenheim,Tom Bischof,GER,"MF,FW",19-330,2005,28.4,95,53,36,45,14,40,77,51.9,37,66,11,55,30,125,53,1
GER-Bundesliga,2425,Hoffenheim,Umut Tohumcu,GER,"MF,FW",20-286,2004,4.2,9,5,3,5,1,5,7,71.4,2,5,0,5,3,12,6,0
GER-Bundesliga,2425,Hoffenheim,Valentin Gendrey,FRA,DF,24-337,2000,15.7,30,12,19,9,2,11,18,61.1,7,19,5,14,15,45,53,0
GER-Bundesliga,2425,Holstein Kiel,Alexander Bernhardsson,SWE,"FW,MF",26-258,1998,14.0,29,15,9,9,11,20,31,64.5,11,14,0,14,5,34,25,0
GER-Bundesliga,2425,Holstein Kiel,Andu Kelati,GER,"MF,DF",22-284,2002,3.2,7,4,2,4,1,2,5,40.0,3,4,1,3,3,10,3,0
GER-Bundesliga,2425,Holstein Kiel,Armin Gigovic,BIH,MF,23-048,2002,21.1,25,13,14,8,3,5,21,23.8,16,20,1,19,21,46,33,0
GER-Bundesliga,2425,Holstein Kiel,Benedikt Pichler,AUT,FW,27-308,1997,8.7,5,2,1,0,4,2,4,50.0,2,4,2,2,2,7,11,0
GER-Bundesliga,2425,Holstein Kiel,Carl Johansson,SWE,DF,31-001,1994,6.3,4,2,4,0,0,3,7,42.9,4,12,8,4,10,14,54,1
GER-Bundesliga,2425,Holstein Kiel,David Zec,SVN,DF,25-139,2000,17.1,23,10,17,6,0,13,20,65.0,7,32,18,14,17,40,93,3
GER-Bundesliga,2425,Holstein Kiel,Dominik Javorček,SVK,"DF,MF",22-203,2002,4.3,3,0,3,0,0,1,5,20.0,4,7,3,4,5,8,26,1
GER-Bundesliga,2425,Holstein Kiel,Finn Porath,GER,"DF,MF",28-090,1997,21.9,45,26,24,14,7,26,53,49.1,27,27,9,18,21,66,67,0
GER-Bundesliga,2425,Holstein Kiel,Ivan Nekić,CRO,DF,24-151,2000,0.8,1,1,1,0,0,1,2,50.0,1,1,0,1,3,4,2,0
GER-Bundesliga,2425,Holstein Kiel,Jann-Fiete Arp,GER,"FW,MF",25-138,2000,7.9,13,10,5,2,6,4,13,30.8,9,6,0,6,3,16,8,1
GER-Bundesliga,2425,Holstein Kiel,John Tolkin,USA,"DF,MF",22-297,2002,8.2,18,11,11,7,0,12,14,85.7,2,10,2,8,8,26,54,0
GER-Bundesliga,2425,Holstein Kiel,Lasse Rosenboom,GER,DF,23-125,2002,19.3,47,35,25,16,6,32,47,68.1,15,28,9,19,19,66,71,3
GER-Bundesliga,2425,Holstein Kiel,Lewis Holtby,GER,MF,34-248,1990,13.8,34,20,19,10,5,12,28,42.9,16,14,2,12,21,55,26,3
GER-Bundesliga,2425,Holstein Kiel,Magnus Knudsen,NOR,MF,23-343,2001,20.6,48,29,21,21,6,25,44,56.8,19,18,4,14,12,60,44,0
GER-Bundesliga,2425,Holstein Kiel,Marco Komenda,CRO,DF,28-179,1996,14.5,26,17,12,13,1,11,15,73.3,4,23,11,12,6,32,68,0
GER-Bundesliga,2425,Holstein Kiel,Marko Ivezić,SRB,DF,23-173,2001,18.4,29,19,20,6,3,15,42,35.7,27,25,13,12,27,56,103,2
GER-Bundesliga,2425,Holstein Kiel,Marvin Schulz,GER,"MF,DF",30-129,1995,3.4,6,5,2,2,2,2,8,25.0,6,12,8,4,0,6,17,0
GER-Bundesliga,2425,Holstein Kiel,Max Geschwill,GER,DF,23-321,2001,14.2,26,21,13,12,1,14,19,73.7,5,14,9,5,30,56,53,1
GER-Bundesliga,2425,Holstein Kiel,Nicolai Remberg,GER,MF,24-339,2000,26.9,45,25,24,17,4,19,41,46.3,22,46,20,26,29,74,100,0
GER-Bundesliga,2425,Holstein Kiel,Patrick Erras,GER,DF,30-123,1995,9.2,8,5,6,2,0,2,9,22.2,7,13,11,2,9,17,64,0
GER-Bundesliga,2425,Holstein Kiel,Phil Harres,GER,FW,23-060,2002,17.2,10,10,3,4,3,4,8,50.0,4,17,3,14,5,15,20,0
GER-Bundesliga,2425,Holstein Kiel,Shuto Machino,JPN,"FW,MF",25-236,1999,21.7,8,5,4,3,1,6,16,37.5,10,12,3,9,7,15,28,1
GER-Bundesliga,2425,Holstein Kiel,Steven Skrzybski,GER,"MF,FW",32-187,1992,14.7,19,6,7,6,6,7,24,29.2,17,16,0,16,11,30,11,0
GER-Bundesliga,2425,Holstein Kiel,Thomas Dähne,GER,GK,31-140,1994,9.0,0,0,0,0,0,0,0,,0,0,0,0,0,0,7,2
GER-Bundesliga,2425,Holstein Kiel,Timo Becker,GER,DF,28-060,1997,27.2,53,33,39,9,5,34,46,73.9,12,30,17,13,17,70,110,1
GER-Bundesliga,2425,Holstein Kiel,Timon Weiner,GER,GK,26-126,1999,25.0,0,0,0,0,0,0,1,0.0,1,0,0,0,0,0,17,3
GER-Bundesliga,2425,Holstein Kiel,Tymoteusz Puchacz,POL,DF,26-121,1999,4.4,9,4,6,3,0,5,7,71.4,2,4,1,3,3,12,11,0
GER-Bundesliga,2425,Leverkusen,Aleix García,ESP,MF,27-330,1997,16.2,13,7,4,6,3,7,15,46.7,8,12,2,10,11,24,24,1
GER-Bundesliga,2425,Leverkusen,Amine Adli,MAR,"MF,FW",25-014,2000,8.5,15,9,4,2,9,4,11,36.4,7,11,0,11,0,15,4,0
GER-Bundesliga,2425,Leverkusen,Arthur,BRA,DF,22-068,2003,8.4,14,11,3,9,2,5,10,50.0,5,8,0,8,9,23,29,0
GER-Bundesliga,2425,Leverkusen,Edmond Tapsoba,BFA,DF,26-111,1999,27.9,39,24,19,16,4,22,39,56.4,17,21,14,7,24,63,89,3
GER-Bundesliga,2425,Leverkusen,Emi Buendía,ARG,MF,28-150,1996,2.9,6,5,1,4,1,5,8,62.5,3,6,0,6,0,6,0,0
GER-Bundesliga,2425,Leverkusen,Exequiel Palacios,ARG,MF,26-231,1998,12.8,22,15,8,10,4,10,18,55.6,8,14,1,13,13,35,15,1
GER-Bundesliga,2425,Leverkusen,Florian Wirtz,GER,"MF,FW",22-021,2003,26.1,32,20,10,12,10,9,22,40.9,13,32,3,29,10,42,6,1
GER-Bundesliga,2425,Leverkusen,Granit Xhaka,SUI,MF,32-239,1992,32.1,48,26,15,27,6,24,42,57.1,18,30,7,23,12,60,52,6
GER-Bundesliga,2425,Leverkusen,Jeanuël Belocian,FRA,"DF,MF",20-096,2005,0.8,1,1,1,0,0,1,1,100.0,0,0,0,0,0,1,2,0
GER-Bundesliga,2425,Leverkusen,Jeremie Frimpong,NED,"DF,MF",24-165,2000,25.7,33,25,14,12,7,16,29,55.2,13,25,0,25,8,41,22,1
GER-Bundesliga,2425,Leverkusen,Jonas Hofmann,GER,"MF,DF",32-314,1992,4.0,2,0,0,2,0,1,4,25.0,3,2,0,2,0,2,3,0
GER-Bundesliga,2425,Leverkusen,Jonathan Tah,GER,DF,29-102,1996,33.0,19,12,12,6,1,10,16,62.5,6,22,16,6,36,55,157,2
GER-Bundesliga,2425,Leverkusen,Lukáš Hrádecký,FIN,GK,35-181,1989,29.0,0,0,0,0,0,0,1,0.0,1,0,0,0,0,0,8,2
GER-Bundesliga,2425,Leverkusen,Mario Hermoso,ESP,DF,29-340,1995,3.3,0,0,0,0,0,0,0,,0,3,1,2,9,9,15,1
GER-Bundesliga,2425,Leverkusen,Martin Terrier,FRA,"MF,FW",28-081,1997,6.5,4,2,1,0,3,1,4,25.0,3,3,0,3,1,5,1,0
GER-Bundesliga,2425,Leverkusen,Matej Kovar,CZE,GK,25-007,2000,5.0,0,0,0,0,0,0,0,,0,0,0,0,0,0,0,1
GER-Bundesliga,2425,Leverkusen,Nathan Tella,NGA,"MF,FW",25-323,1999,15.1,16,11,4,7,5,5,13,38.5,8,15,1,14,4,20,10,0
GER-Bundesliga,2425,Leverkusen,Nordi Mukiele,FRA,DF,27-204,1997,10.0,20,16,8,8,4,12,18,66.7,6,10,0,10,16,36,37,2
GER-Bundesliga,2425,Leverkusen,Patrik Schick,CZE,FW,29-120,1996,18.7,6,5,1,3,2,1,5,20.0,4,9,1,8,4,10,17,1
GER-Bundesliga,2425,Leverkusen,Piero Hincapié,ECU,DF,23-135,2002,29.7,52,40,27,15,10,25,41,61.0,16,40,20,20,32,84,114,1
GER-Bundesliga,2425,Leverkusen,Robert Andrich,GER,"MF,DF",30-244,1994,17.8,24,12,8,14,2,7,14,50.0,7,16,8,8,29,53,23,0
GER-Bundesliga,2425,Leverkusen,Victor Boniface,NGA,FW,24-152,2000,11.2,5,4,0,3,2,3,4,75.0,1,1,0,1,0,5,5,0
GER-Bundesliga,2425,Leverkusen,Álex Grimaldo,ESP,DF,29-246,1995,29.3,24,14,13,7,4,16,42,38.1,26,22,3,19,16,40,43,3
GER-Bundesliga,2425,Mainz 05,Andreas Hanche-Olsen,NOR,DF,28-127,1997,14.3,21,13,12,8,1,9,12,75.0,3,25,18,7,12,33,85,2
GER-Bundesliga,2425,Mainz 05,Anthony Caci,FRA,DF,27-327,1997,29.8,60,40,23,25,12,28,44,63.6,16,33,8,25,27,87,47,2
GER-Bundesliga,2425,Mainz 05,Armindo Sieb,GER,"FW,MF",22-096,2003,8.5,10,4,4,5,1,3,10,30.0,7,4,0,4,1,11,7,0
GER-Bundesliga,2425,Mainz 05,Arnaud Nordin,FRA,"DF,MF",26-341,1998,0.9,2,0,0,2,0,1,1,100.0,0,2,1,1,0,2,2,0
GER-Bundesliga,2425,Mainz 05,Aymen Barkok,MAR,MF,27-003,1998,0.8,2,1,1,1,0,1,1,100.0,0,1,1,0,2,4,0,0
GER-Bundesliga,2425,Mainz 05,Danny da Costa,GER,DF,31-315,1993,22.3,42,23,23,15,4,17,27,63.0,10,19,10,9,27,69,95,3
GER-Bundesliga,2425,Mainz 05,Dominik Kohr,GER,"DF,MF",31-113,1994,25.5,62,46,34,21,7,35,55,63.6,20,43,24,19,42,104,127,0
GER-Bundesliga,2425,Mainz 05,Gabriel Vidovic,CRO,MF,21-174,2003,0.0,0,0,0,0,0,0,0,,0,0,0,0,0,0,0,0
GER-Bundesliga,2425,Mainz 05,Hong Hyunseok,KOR,MF,25-342,1999,5.9,8,3,3,3,2,1,4,25.0,3,7,1,6,7,15,9,0
GER-Bundesliga,2425,Mainz 05,Jonathan Burkardt,GER,FW,24-317,2000,23.4,15,8,1,7,7,6,10,60.0,4,11,1,10,1,16,14,0
GER-Bundesliga,2425,Mainz 05,Kaishu Sano,JPN,MF,24-145,2000,33.8,61,36,22,31,8,25,52,48.1,27,66,14,52,65,126,56,1
GER-Bundesliga,2425,Mainz 05,Karim Onisiwo,AUT,"MF,FW",33-068,1992,1.2,1,1,0,0,1,0,0,,0,0,0,0,0,1,0,0
GER-Bundesliga,2425,Mainz 05,Lasse Rieß,GER,GK,23-301,2001,2.0,0,0,0,0,0,0,0,,0,0,0,0,0,0,5,0
GER-Bundesliga,2425,Mainz 05,Lee Jae-sung,KOR,MF,32-287,1992,29.4,42,21,16,19,7,15,39,38.5,24,39,3,36,35,77,38,0
GER-Bundesliga,2425,Mainz 05,Lennard Maloney,USA,MF,25-228,1999,0.3,2,1,0,1,1,1,1,100.0,0,2,0,2,0,2,3,0
GER-Bundesliga,2425,Mainz 05,Maxim Leitsch,GER,DF,27-006,1998,7.5,12,4,6,4,2,7,9,77.8,2,12,4,8,10,22,42,1
GER-Bundesliga,2425,Mainz 05,Moritz Jenz,GER,DF,26-024,1999,17.8,36,20,18,18,0,16,21,76.2,5,23,14,9,30,66,128,2
GER-Bundesliga,2425,Mainz 05,Nadiem Amiri,GER,MF,28-209,1996,27.5,50,23,13,28,9,19,46,41.3,27,19,4,15,16,66,30,2
GER-Bundesliga,2425,Mainz 05,Nelson Weiper,GER,"FW,MF",20-068,2005,7.8,5,4,2,3,0,2,4,50.0,2,5,0,5,2,7,5,1
GER-Bundesliga,2425,Mainz 05,Nikolas Veratschnig,AUT,"DF,MF",22-120,2003,4.0,9,6,1,4,4,2,3,66.7,1,4,0,4,5,14,8,0
GER-Bundesliga,2425,Mainz 05,Paul Nebel,GER,MF,22-226,2002,26.1,38,24,11,18,9,11,35,31.4,24,54,4,50,13,51,30,2
GER-Bundesliga,2425,Mainz 05,Phillipp Mwene,AUT,DF,31-115,1994,29.0,51,29,23,22,6,19,46,41.3,27,27,6,21,24,75,51,1
GER-Bundesliga,2425,Mainz 05,Robin Zentner,GER,GK,30-208,1994,32.0,2,1,2,0,0,1,2,50.0,1,0,0,0,0,2,31,4
GER-Bundesliga,2425,Mainz 05,Silvan Widmer,SUI,DF,32-080,1993,5.6,11,5,3,6,2,8,12,66.7,4,7,1,6,5,16,27,0
GER-Bundesliga,2425,Mainz 05,Stefan Bell,GER,DF,33-273,1991,16.0,22,12,16,6,0,9,14,64.3,5,16,14,2,28,50,107,1
GER-Bundesliga,2425,RB Leipzig,Amadou Haidara,MLI,MF,27-113,1998,14.7,30,17,12,16,2,12,29,41.4,17,42,12,30,18,48,56,1
GER-Bundesliga,2425,RB Leipzig,André Silva,POR,"FW,MF",29-199,1995,1.5,1,1,1,0,0,0,1,0.0,1,1,0,1,1,2,2,0
GER-Bundesliga,2425,RB Leipzig,Antonio Nusa,NOR,"MF,DF",20-037,2005,17.3,30,17,16,9,5,18,36,50.0,18,22,2,20,8,38,11,0
GER-Bundesliga,2425,RB Leipzig,Arthur Vermeeren,BEL,MF,20-106,2005,17.5,32,19,14,13,5,14,47,29.8,33,34,12,22,23,55,25,2
GER-Bundesliga,2425,RB Leipzig,Assan Ouedraogo,GER,MF,19-015,2006,0.6,0,0,0,0,0,0,0,,0,1,0,1,0,0,0,0
GER-Bundesliga,2425,RB Leipzig,Benjamin Henrichs,GER,DF,28-090,1997,10.4,32,16,18,10,4,14,27,51.9,13,22,3,19,15,47,33,0
GER-Bundesliga,2425,RB Leipzig,Benjamin Šeško,SVN,"FW,MF",21-358,2003,26.4,7,3,0,4,3,3,11,27.3,8,15,4,11,5,12,20,0
GER-Bundesliga,2425,RB Leipzig,Castello Lukeba,FRA,DF,22-158,2002,17.5,31,17,15,12,4,17,24,70.8,7,29,12,17,17,48,74,0
GER-Bundesliga,2425,RB Leipzig,Christoph Baumgartner,AUT,MF,25-296,1999,17.9,44,28,13,19,12,17,42,40.5,25,45,9,36,12,56,24,2
GER-Bundesliga,2425,RB Leipzig,David Raum,GER,DF,27-032,1998,19.8,38,28,16,14,8,20,35,57.1,15,25,8,17,9,47,47,4
GER-Bundesliga,2425,RB Leipzig,El Chadaille Bitshiabu,FRA,DF,20-008,2005,12.6,27,18,17,9,1,10,19,52.6,9,25,14,11,13,40,97,2
GER-Bundesliga,2425,RB Leipzig,Elif Elmas,MKD,MF,25-242,1999,0.5,3,1,3,0,0,1,3,33.3,2,2,0,2,0,3,2,0
GER-Bundesliga,2425,RB Leipzig,Faik Sakar,GER,MF,17-130,2008,0.0,0,0,0,0,0,0,0,,0,0,0,0,0,0,0,0
GER-Bundesliga,2425,RB Leipzig,Kevin Kampl,SVN,MF,34-227,1990,17.7,27,18,11,10,6,16,26,61.5,10,25,6,19,24,51,25,0
GER-Bundesliga,2425,RB Leipzig,Kosta Nedeljković,SRB,DF,19-159,2005,5.3,11,8,5,6,0,6,10,60.0,4,6,4,2,2,13,14,0
GER-Bundesliga,2425,RB Leipzig,Loïs Openda,BEL,"FW,MF",25-097,2000,27.3,9,4,3,4,2,3,11,27.3,8,19,1,18,5,14,12,0
GER-Bundesliga,2425,RB Leipzig,Lukas Klostermann,GER,DF,28-355,1996,20.4,27,14,18,7,2,14,24,58.3,10,31,17,14,24,51,143,3
GER-Bundesliga,2425,RB Leipzig,Lutsharel Geertruida,NED,DF,24-310,2000,17.3,35,24,24,11,0,15,31,48.4,16,15,4,11,16,51,59,4
GER-Bundesliga,2425,RB Leipzig,Maarten Vandevoordt,BEL,GK,23-087,2002,4.8,1,0,1,0,0,1,1,100.0,0,0,0,0,0,1,4,0
GER-Bundesliga,2425,RB Leipzig,Mohamed Simakan,FRA,DF,25-021,2000,0.6,0,0,0,0,0,0,0,,0,0,0,0,2,2,0,0
GER-Bundesliga,2425,RB Leipzig,Nicolas Seiwald,AUT,"MF,DF",24-020,2001,23.2,53,31,19,29,5,25,50,50.0,25,43,10,33,31,84,76,2
GER-Bundesliga,2425,RB Leipzig,Péter Gulácsi,HUN,GK,35-018,1990,29.2,1,1,1,0,0,1,2,50.0,1,0,0,0,0,1,16,4
GER-Bundesliga,2425,RB Leipzig,Ridle Baku,GER,"DF,MF",27-046,1998,14.2,24,19,9,13,2,9,23,39.1,14,18,2,16,9,33,45,0
GER-Bundesliga,2425,RB Leipzig,Tidiam Gomis,FRA,"MF,FW",18-289,2006,1.7,0,0,0,0,0,0,0,,0,2,0,2,1,1,0,0
GER-Bundesliga,2425,RB Leipzig,Viggo Gebel,GER,MF,17-183,2007,0.2,0,0,0,0,0,0,0,,0,0,0,0,0,0,0,0
GER-Bundesliga,2425,RB Leipzig,Willi Orban,HUN,DF,32-202,1992,24.7,38,21,23,14,1,23,32,71.9,9,45,31,14,21,59,169,4
GER-Bundesliga,2425,RB Leipzig,Xaver Schlager,AUT,MF,27-238,1997,2.0,4,2,2,1,1,3,7,42.9,4,7,0,7,0,4,3,0
GER-Bundesliga,2425,RB Leipzig,Xavi Simons,NED,MF,22-033,2003,23.9,28,21,5,15,8,12,26,46.2,14,19,3,16,12,40,19,1
GER-Bundesliga,2425,RB Leipzig,Yussuf Poulsen,DEN,"FW,MF",30-343,1994,4.2,10,5,2,6,2,4,8,50.0,4,7,2,5,0,10,14,0
GER-Bundesliga,2425,St. Pauli,Abdoulie Ceesay,GAM,FW,21-139,2004,0.7,3,3,1,1,1,2,3,66.7,1,2,0,2,0,3,1,0
GER-Bundesliga,2425,St. Pauli,Adam Dźwigała,POL,"DF,MF",29-241,1995,4.1,20,10,13,6,1,11,16,68.8,5,6,1,5,4,24,28,0
GER-Bundesliga,2425,St. Pauli,Andreas Albers,DEN,FW,35-062,1990,0.7,1,1,0,0,1,0,1,0.0,1,0,0,0,0,1,1,0
GER-Bundesliga,2425,St. Pauli,Ben Alexander Voll,GER,GK,24-166,2000,1.0,0,0,0,0,0,0,0,,0,0,0,0,0,0,0,0
GER-Bundesliga,2425,St. Pauli,Carlo Boukhalfa,MAR,MF,26-021,1999,18.3,26,11,7,17,2,7,19,36.8,12,22,3,19,12,38,25,1
GER-Bundesliga,2425,St. Pauli,Connor Metcalfe,AUS,"MF,FW",25-200,1999,4.0,2,0,1,1,0,0,5,0.0,5,4,0,4,3,5,8,0
GER-Bundesliga,2425,St. Pauli,Danel Sinani,LUX,"FW,MF",28-049,1997,13.9,14,11,2,7,5,6,14,42.9,8,12,1,11,1,15,13,0
GER-Bundesliga,2425,St. Pauli,David Nemeth,AUT,DF,24-067,2001,23.7,43,29,25,16,2,25,43,58.1,18,29,11,18,18,61,94,2
GER-Bundesliga,2425,St. Pauli,Elias Saad,TUN,"FW,MF",25-148,1999,10.0,20,13,7,8,5,10,20,50.0,10,14,0,14,3,23,1,0
GER-Bundesliga,2425,St. Pauli,Eric Smith,SWE,"DF,MF",28-136,1997,31.4,46,29,26,17,3,23,40,57.5,17,37,10,27,37,83,104,4
GER-Bundesliga,2425,St. Pauli,Erik Ahlstrand,SWE,"FW,MF",23-222,2001,0.5,0,0,0,0,0,0,0,,0,1,0,1,1,1,1,0
GER-Bundesliga,2425,St. Pauli,Finley Stevens,WAL,DF,22-044,2003,0.0,0,0,0,0,0,0,0,,0,0,0,0,0,0,0,0
GER-Bundesliga,2425,St. Pauli,Hauke Wahl,GER,DF,31-039,1994,33.0,36,27,21,13,2,23,38,60.5,15,44,25,19,31,67,170,4
GER-Bundesliga,2425,St. Pauli,Jackson Irvine,AUS,MF,32-078,1993,29.0,56,28,24,26,6,25,45,55.6,20,27,5,22,36,92,63,2
GER-Bundesliga,2425,St. Pauli,James Sands,USA,"MF,DF",24-322,2000,5.0,15,6,5,8,2,4,4,100.0,0,5,1,4,5,20,8,0
GER-Bundesliga,2425,St. Pauli,Johannes Eggestein,GER,FW,27-016,1998,20.6,5,3,0,2,3,1,5,20.0,4,5,0,5,0,5,8,0
GER-Bundesliga,2425,St. Pauli,Karol Mets,EST,DF,32-008,1993,10.0,13,8,6,7,0,4,7,57.1,3,9,3,6,12,25,60,0
GER-Bundesliga,2425,St. Pauli,Lars Ritzka,GER,"DF,MF",27-017,1998,10.2,49,29,28,16,5,25,41,61.0,16,16,2,14,11,60,41,0
GER-Bundesliga,2425,St. Pauli,Manolis Saliakas,GRE,"MF,DF",28-254,1996,25.7,46,22,24,18,4,25,49,51.0,24,38,8,30,20,66,62,0
GER-Bundesliga,2425,St. Pauli,Maurides,BRA,FW,31-075,1994,0.0,0,0,0,0,0,0,0,,0,0,0,0,0,0,0,0
GER-Bundesliga,2425,St. Pauli,Morgan Guilavogui,GUI,"FW,MF",27-075,1998,20.1,32,17,11,16,5,14,31,45.2,17,28,0,28,13,45,33,0
GER-Bundesliga,2425,St. Pauli,Nikola Vasilj,BIH,GK,29-173,1995,33.0,0,0,0,0,0,0,2,0.0,2,0,0,0,0,0,22,3
GER-Bundesliga,2425,St. Pauli,Noah Weißhaupt,GER,"FW,MF",23-246,2001,12.9,6,4,3,0,3,3,8,37.5,5,7,0,7,2,8,8,1
GER-Bundesliga,2425,St. Pauli,Oladapo Afolayan,ENG,"FW,MF",27-101,1998,18.2,17,8,4,8,5,7,19,36.8,12,17,1,16,8,25,20,0
GER-Bundesliga,2425,St. Pauli,Philipp Treu,GER,"MF,DF",24-172,2000,32.0,61,42,35,17,9,39,68,57.4,29,52,12,40,19,80,87,2
GER-Bundesliga,2425,St. Pauli,Robert Wagner,GER,MF,21-314,2003,4.5,8,3,2,6,0,4,13,30.8,9,8,0,8,2,10,12,0
GER-Bundesliga,2425,St. Pauli,Scott Banks,SCO,"FW,MF",23-240,2001,1.3,1,1,1,0,0,0,2,0.0,2,0,0,0,2,3,2,0
GER-Bundesliga,2425,St. Pauli,Siebe Van Der Heyden,BEL,"DF,MF",26-359,1998,9.7,17,10,10,7,0,8,18,44.4,10,8,4,4,17,34,43,2
GER-Bundesliga,2425,Stuttgart,Alexander Nübel,GER,GK,28-236,1996,34.0,0,0,0,0,0,0,1,0.0,1,0,0,0,0,0,18,3
GER-Bundesliga,2425,Stuttgart,Ameen Al-Dakhil,BEL,DF,23-079,2002,4.8,6,6,4,2,0,4,4,100.0,0,12,8,4,9,15,30,1
GER-Bundesliga,2425,Stuttgart,Angelo Stiller,GER,MF,24-050,2001,30.5,49,27,18,25,6,14,30,46.7,16,29,9,20,26,75,50,4
GER-Bundesliga,2425,Stuttgart,Anrie Chase,JPN,DF,21-061,2004,8.2,10,4,6,4,0,5,7,71.4,2,10,6,4,9,19,35,0
GER-Bundesliga,2425,Stuttgart,Anthony Rouault,FRA,DF,23-360,2001,13.5,15,11,10,3,2,10,15,66.7,5,18,9,9,19,34,63,1
GER-Bundesliga,2425,Stuttgart,Atakan Karazor,,MF,28-223,1996,29.1,59,29,19,28,12,29,57,50.9,28,39,7,32,32,91,51,1
GER-Bundesliga,2425,Stuttgart,Chris Führich,GER,"MF,FW",27-135,1998,22.0,15,10,5,5,5,13,27,48.1,14,23,2,21,6,21,19,0
GER-Bundesliga,2425,Stuttgart,Dan-Axel Zagadou,FRA,"DF,MF",25-355,1999,0.3,0,0,0,0,0,0,0,,0,0,0,0,1,1,1,0
GER-Bundesliga,2425,Stuttgart,Deniz Undav,GER,"FW,MF",28-309,1996,19.2,11,10,2,3,6,1,17,5.9,16,15,2,13,3,14,10,0
GER-Bundesliga,2425,Stuttgart,El Bilal Touré,MLI,"FW,MF",23-233,2001,4.0,4,1,1,1,2,3,3,100.0,0,1,0,1,0,4,1,0
GER-Bundesliga,2425,Stuttgart,Enzo Millot,FRA,"MF,FW",22-311,2002,20.5,30,13,10,15,5,12,35,34.3,23,27,0,27,13,43,6,1
GER-Bundesliga,2425,Stuttgart,Ermedin Demirović,BIH,FW,27-060,1998,20.6,12,7,3,4,5,3,12,25.0,9,14,3,11,3,15,12,0
GER-Bundesliga,2425,Stuttgart,Fabian Rieder,SUI,"MF,FW",23-097,2002,9.6,17,14,4,9,4,7,23,30.4,16,10,1,9,10,27,7,1
GER-Bundesliga,2425,Stuttgart,Finn Jeltsch,GER,DF,18-311,2006,8.7,18,13,6,11,1,12,15,80.0,3,12,6,6,13,31,27,2
GER-Bundesliga,2425,Stuttgart,Frans Krätzig,GER,DF,22-130,2003,0.6,2,1,1,0,1,1,3,33.3,2,2,1,1,0,2,1,0
GER-Bundesliga,2425,Stuttgart,Jacob Bruun Larsen,DEN,"MF,FW",26-247,1998,4.6,1,1,1,0,0,0,2,0.0,2,7,0,7,1,2,4,1
GER-Bundesliga,2425,Stuttgart,Jamie Leweling,GER,"MF,FW",24-087,2001,18.5,16,6,6,3,7,11,25,44.0,14,22,1,21,11,27,17,1
GER-Bundesliga,2425,Stuttgart,Jarzinho Malanga,GER,DF,18-318,2006,0.0,0,0,0,0,0,0,0,,0,0,0,0,0,0,0,0
GER-Bundesliga,2425,Stuttgart,Josha Vagnoman,GER,"DF,MF",24-164,2000,20.4,26,14,11,13,2,17,34,50.0,17,16,2,14,14,40,57,1
GER-Bundesliga,2425,Stuttgart,Julian Chabot,GER,DF,27-101,1998,25.2,37,24,19,15,3,15,32,46.9,17,29,19,10,38,75,135,0
GER-Bundesliga,2425,Stuttgart,Justin Diehl,GER,"FW,DF",20-178,2004,1.2,1,0,0,1,0,1,1,100.0,0,2,0,2,0,1,0,0
GER-Bundesliga,2425,Stuttgart,Leonidas Stergiou,SUI,DF,23-082,2002,9.5,24,13,9,11,4,16,19,84.2,3,16,5,11,14,38,39,0
GER-Bundesliga,2425,Stuttgart,Luca Jaquez,SUI,DF,21-356,2003,2.8,3,0,3,0,0,1,3,33.3,2,2,0,2,3,6,4,0
GER-Bundesliga,2425,Stuttgart,Maximilian Mittelstädt,GER,DF,28-067,1997,27.4,79,54,42,30,7,53,73,72.6,20,47,11,36,47,126,96,2
GER-Bundesliga,2425,Stuttgart,Nick Woltemade,GER,"FW,MF",23-099,2002,18.0,10,7,2,4,4,6,10,60.0,4,23,2,21,1,11,15,1
GER-Bundesliga,2425,Stuttgart,Nikolas Nartey,DEN,MF,25-091,2000,0.2,0,0,0,0,0,0,0,,0,0,0,0,0,0,4,0
GER-Bundesliga,2425,Stuttgart,Pascal Stenzel,GER,DF,29-065,1996,3.2,3,2,1,0,2,2,5,40.0,3,5,1,4,2,5,6,0
GER-Bundesliga,2425,Stuttgart,Ramon Hendriks,NED,DF,23-310,2001,12.8,20,9,11,7,2,9,13,69.2,4,15,7,8,19,39,63,0
GER-Bundesliga,2425,Stuttgart,Yannik Keitel,GER,MF,25-098,2000,3.0,9,6,3,5,1,9,10,90.0,1,5,2,3,4,13,6,0
GER-Bundesliga,2425,Union Berlin,Alexander Schwolow,GER,GK,32-356,1992,6.0,0,0,0,0,0,0,0,,0,0,0,0,0,0,2,1
GER-Bundesliga,2425,Union Berlin,Aljoscha Kemlein,GER,MF,20-295,2004,10.2,10,4,4,5,1,5,14,35.7,9,14,3,11,6,16,15,0
GER-Bundesliga,2425,Union Berlin,Andrej Ilic,SRB,FW,25-051,2000,10.4,2,2,0,2,0,0,6,0.0,6,7,3,4,5,7,6,1
GER-Bundesliga,2425,Union Berlin,András Schäfer,HUN,MF,26-041,1999,17.0,52,26,23,24,5,25,41,61.0,16,33,6,27,22,74,36,0
GER-Bundesliga,2425,Union Berlin,Benedict Hollerbach,GER,"FW,MF",24-007,2001,28.2,43,22,8,23,12,21,51,41.2,30,35,0,35,2,45,13,1
GER-Bundesliga,2425,Union Berlin,Christopher Trimmel,AUT,"DF,MF",38-089,1987,19.3,38,25,23,14,1,28,42,66.7,14,14,6,8,18,56,92,0
GER-Bundesliga,2425,Union Berlin,Danilho Doekhi,NED,DF,26-328,1998,34.0,37,24,18,16,3,13,23,56.5,10,35,16,19,44,81,169,1
GER-Bundesliga,2425,Union Berlin,David Preu,GER,"MF,DF",20-210,2004,1.3,1,1,0,1,0,0,2,0.0,2,4,2,2,0,1,2,0
GER-Bundesliga,2425,Union Berlin,Diogo Leite,POR,DF,26-121,1999,28.3,64,32,43,17,4,33,50,66.0,17,61,25,36,57,121,162,1
GER-Bundesliga,2425,Union Berlin,Frederik Rønnow,DEN,GK,32-293,1992,28.0,0,0,0,0,0,0,1,0.0,1,0,0,0,0,0,22,2
GER-Bundesliga,2425,Union Berlin,Ivan Prtajin,CRO,FW,29-010,1996,1.8,3,2,0,1,2,0,0,,0,2,0,2,0,3,3,0
GER-Bundesliga,2425,Union Berlin,Janik Haberer,GER,"MF,DF",31-052,1994,18.8,39,29,16,21,2,26,44,59.1,18,16,0,16,17,56,37,0
GER-Bundesliga,2425,Union Berlin,Jeong Woo-yeong,KOR,"MF,FW",25-246,1999,14.0,10,7,5,5,0,3,11,27.3,8,10,1,9,11,21,11,0
GER-Bundesliga,2425,Union Berlin,Jordan Pefok,USA,FW,29-028,1996,10.1,11,6,6,0,5,3,7,42.9,4,9,2,7,4,15,18,0
GER-Bundesliga,2425,Union Berlin,Josip Juranović,CRO,"DF,MF",29-281,1995,12.9,21,13,12,6,3,10,25,40.0,15,13,6,7,7,28,42,2
GER-Bundesliga,2425,Union Berlin,Jérôme Roussillon,FRA,"DF,MF",32-138,1993,1.5,0,0,0,0,0,0,2,0.0,2,0,0,0,2,2,7,0
GER-Bundesliga,2425,Union Berlin,Kevin Vogt,GER,DF,33-243,1991,15.2,12,8,7,5,0,8,13,61.5,5,16,8,8,9,21,75,1
GER-Bundesliga,2425,Union Berlin,Kevin Volland,GER,"FW,MF",32-298,1992,0.7,0,0,0,0,0,0,0,,0,1,0,1,0,0,1,0
GER-Bundesliga,2425,Union Berlin,Leopold Querfeld,AUT,DF,21-155,2003,19.4,25,12,21,4,0,13,18,72.2,5,25,10,15,19,44,144,2
GER-Bundesliga,2425,Union Berlin,Lucas Tousart,FRA,MF,28-025,1997,6.2,17,9,6,9,2,5,12,41.7,7,11,4,7,7,24,27,0
GER-Bundesliga,2425,Union Berlin,László Bénes,SVK,"MF,FW",27-257,1997,6.5,2,2,1,1,0,1,3,33.3,2,5,1,4,3,5,9,0
GER-Bundesliga,2425,Union Berlin,Marin Ljubicic,CRO,"FW,MF",23-085,2002,3.1,2,1,0,2,0,1,3,33.3,2,2,0,2,0,2,7,0
GER-Bundesliga,2425,Union Berlin,Rani Khedira,GER,MF,31-117,1994,30.3,68,40,30,35,3,24,38,63.2,14,33,11,22,44,112,55,0
GER-Bundesliga,2425,Union Berlin,Robert Skov,DEN,"DF,MF",29-004,1996,9.5,15,11,8,7,0,10,20,50.0,10,8,1,7,8,23,9,0
GER-Bundesliga,2425,Union Berlin,Robin Gosens,GER,DF,30-323,1994,1.0,0,0,0,0,0,0,3,0.0,3,1,0,1,1,1,2,0
GER-Bundesliga,2425,Union Berlin,Tim Skarke,GER,"FW,MF",28-259,1996,12.9,14,11,5,8,1,10,19,52.6,9,7,0,7,5,19,17,0
GER-Bundesliga,2425,Union Berlin,Tom Rothe,GER,"DF,MF",20-207,2004,18.6,45,28,27,15,3,29,51,56.9,22,41,5,36,18,63,57,1
GER-Bundesliga,2425,Union Berlin,Yorbe Vertessen,BEL,"MF,FW",24-136,2001,8.0,6,3,3,2,1,2,8,25.0,6,6,0,6,3,9,6,0
GER-Bundesliga,2425,Werder Bremen,Amos Pieper,GER,DF,27-127,1998,16.6,32,17,16,11,5,21,33,63.6,12,28,17,11,24,56,98,1
GER-Bundesliga,2425,Werder Bremen,André Silva,POR,FW,29-199,1995,4.2,2,2,1,1,0,0,1,0.0,1,3,1,2,0,2,3,0
GER-Bundesliga,2425,Werder Bremen,Anthony Jung,GER,DF,33-202,1991,21.1,34,22,22,11,1,22,34,64.7,12,23,14,9,25,59,77,1
GER-Bundesliga,2425,Werder Bremen,Derrick Köhn,GER,"DF,FW",26-109,1999,14.9,20,10,7,10,3,10,14,71.4,4,21,4,17,10,30,26,0
GER-Bundesliga,2425,Werder Bremen,Felix Agu,GER,DF,25-239,1999,19.5,30,14,12,14,4,12,23,52.2,11,27,9,18,21,51,48,0
GER-Bundesliga,2425,Werder Bremen,Issa Kaboré,BFA,"DF,FW",24-012,2001,3.4,8,4,2,5,1,4,6,66.7,2,8,2,6,2,10,7,0
GER-Bundesliga,2425,Werder Bremen,Jens Stage,DEN,MF,28-197,1996,24.5,49,30,22,24,3,25,46,54.3,21,44,10,34,18,67,42,2
GER-Bundesliga,2425,Werder Bremen,Julián Malatini,ARG,DF,23-358,2001,5.0,11,9,5,5,1,5,11,45.5,6,8,3,5,7,18,17,0
GER-Bundesliga,2425,Werder Bremen,Justin Njinmah,GER,"FW,MF",24-190,2000,10.6,6,2,1,4,1,3,5,60.0,2,5,0,5,3,9,1,0
GER-Bundesliga,2425,Werder Bremen,Keke Maximilian Topp,GER,"FW,MF",21-060,2004,2.8,3,1,0,2,1,1,2,50.0,1,0,0,0,1,4,4,0
GER-Bundesliga,2425,Werder Bremen,Leonardo Bittencourt,GER,MF,31-156,1993,10.9,25,9,15,7,3,6,18,33.3,12,8,0,8,15,40,11,0
GER-Bundesliga,2425,Werder Bremen,Marco Friedl,AUT,DF,27-069,1998,24.0,62,42,35,26,1,38,66,57.6,28,41,24,17,34,96,130,1
GER-Bundesliga,2425,Werder Bremen,Marco Grüll,AUT,"FW,MF",26-322,1998,13.1,12,9,1,5,6,4,17,23.5,13,14,2,12,3,15,10,0
GER-Bundesliga,2425,Werder Bremen,Marvin Ducksch,GER,FW,31-078,1994,26.9,10,7,3,5,2,3,14,21.4,11,10,2,8,8,18,26,3
GER-Bundesliga,2425,Werder Bremen,Michael Zetterer,GER,GK,29-316,1995,34.0,0,0,0,0,0,0,1,0.0,1,1,0,1,1,1,10,7
GER-Bundesliga,2425,Werder Bremen,Miloš Veljković,SRB,DF,29-240,1995,11.4,10,5,6,3,1,7,15,46.7,8,14,9,5,2,12,47,1
GER-Bundesliga,2425,Werder Bremen,Mitchell Weiser,GER,"DF,MF",31-033,1994,31.9,61,40,19,34,8,28,56,50.0,28,33,3,30,22,83,61,3
GER-Bundesliga,2425,Werder Bremen,Niklas Stark,GER,DF,30-040,1995,23.4,33,21,20,11,2,14,21,66.7,7,41,27,14,36,69,129,1
GER-Bundesliga,2425,Werder Bremen,Oliver Burke,SCO,FW,28-047,1997,10.1,11,4,5,1,5,4,6,66.7,2,20,0,20,2,13,6,0
GER-Bundesliga,2425,Werder Bremen,Olivier Deman,BEL,DF,25-048,2000,0.7,6,3,2,4,0,2,7,28.6,5,3,1,2,3,9,4,0
GER-Bundesliga,2425,Werder Bremen,Romano Schmid,AUT,MF,25-117,2000,31.5,43,25,10,22,11,24,51,47.1,27,42,3,39,11,54,9,2
GER-Bundesliga,2425,Werder Bremen,Senne Lynen,BEL,MF,26-094,1999,30.4,72,39,36,30,6,39,69,56.5,30,56,13,43,65,137,75,5
GER-Bundesliga,2425,Werder Bremen,Skelly Alvero,FRA,MF,23-020,2002,2.6,11,6,5,5,1,4,5,80.0,1,4,0,4,2,13,10,0
GER-Bundesliga,2425,Wolfsburg,Andreas Skov Olsen,DEN,"FW,MF",25-146,1999,5.9,8,6,5,3,0,4,4,100.0,0,4,0,4,2,10,12,0
GER-Bundesliga,2425,Wolfsburg,Aster Vranckx,BEL,MF,22-232,2002,6.2,11,6,3,8,0,3,9,33.3,6,14,3,11,10,21,13,0
GER-Bundesliga,2425,Wolfsburg,Bence Dárdai,HUN,MF,19-120,2006,14.5,24,14,9,13,2,16,30,53.3,14,20,4,16,12,36,28,1
GER-Bundesliga,2425,Wolfsburg,Cedric Zesiger,SUI,DF,26-334,1998,5.8,13,8,6,5,2,6,12,50.0,6,6,5,1,3,16,28,0
GER-Bundesliga,2425,Wolfsburg,David Odogu,GER,DF,18-355,2006,2.2,6,4,4,2,0,3,5,60.0,2,2,2,0,2,8,25,1
GER-Bundesliga,2425,Wolfsburg,Denis Vavro,SVK,DF,29-044,1996,27.3,21,13,16,5,0,11,23,47.8,12,48,32,16,37,58,234,3
GER-Bundesliga,2425,Wolfsburg,Jakub Kamiński,POL,"DF,MF",22-353,2002,12.6,17,8,8,3,6,9,22,40.9,13,17,7,10,13,30,23,1
GER-Bundesliga,2425,Wolfsburg,Joakim Mæhle,DEN,DF,28-004,1997,24.3,34,15,26,6,2,17,45,37.8,28,24,3,21,25,59,57,2
GER-Bundesliga,2425,Wolfsburg,Jonas Wind,DEN,"FW,MF",26-106,1999,21.8,10,6,1,8,1,4,8,50.0,4,17,3,14,6,16,15,0
GER-Bundesliga,2425,Wolfsburg,Kamil Grabara,POL,GK,26-136,1999,28.7,0,0,0,0,0,0,2,0.0,2,1,0,1,0,0,16,2
GER-Bundesliga,2425,Wolfsburg,Kevin Behrens,GER,FW,34-110,1991,1.9,1,1,0,1,0,0,1,0.0,1,0,0,0,1,2,2,0
GER-Bundesliga,2425,Wolfsburg,Kevin Paredes,USA,DF,22-017,2003,1.4,3,1,3,0,0,2,3,66.7,1,2,2,0,1,4,0,0
GER-Bundesliga,2425,Wolfsburg,Kilian Fischer,GER,DF,24-224,2000,25.5,64,44,48,12,4,47,89,52.8,42,41,8,33,19,83,98,2
GER-Bundesliga,2425,Wolfsburg,Konstantinos Koulierakis,GRE,DF,21-177,2003,27.4,40,20,25,13,2,25,40,62.5,15,34,14,20,33,73,147,2
GER-Bundesliga,2425,Wolfsburg,Lovro Majer,CRO,MF,27-127,1998,3.4,2,1,0,1,1,1,5,20.0,4,5,1,4,1,3,2,1
GER-Bundesliga,2425,Wolfsburg,Lukas Nmecha,GER,"FW,MF",26-161,1998,5.2,2,0,1,1,0,0,1,0.0,1,3,0,3,2,4,4,0
GER-Bundesliga,2425,Wolfsburg,Mads Roerslev,DEN,DF,25-334,1999,3.3,10,9,8,1,1,6,9,66.7,3,2,2,0,5,15,16,0
GER-Bundesliga,2425,Wolfsburg,Marius Müller,GER,GK,31-316,1993,5.3,0,0,0,0,0,0,0,,0,0,0,0,0,0,0,0
GER-Bundesliga,2425,Wolfsburg,Mattias Svanberg,SWE,MF,26-139,1999,13.5,20,10,6,11,3,9,19,47.4,10,11,4,7,15,35,26,0
GER-Bundesliga,2425,Wolfsburg,Maximilian Arnold,GER,MF,30-362,1994,26.2,34,20,13,18,3,15,33,45.5,18,21,11,10,24,58,70,2
GER-Bundesliga,2425,Wolfsburg,Mohamed Amoura,ALG,FW,25-015,2000,27.4,29,22,14,5,10,14,37,37.8,23,42,2,40,9,38,24,0
GER-Bundesliga,2425,Wolfsburg,Patrick Wimmer,AUT,"MF,FW",23-359,2001,19.7,47,35,19,21,7,15,46,32.6,31,31,4,27,32,79,15,2
GER-Bundesliga,2425,Wolfsburg,Ridle Baku,GER,"FW,MF",27-046,1998,13.0,23,15,9,9,5,8,19,42.1,11,22,1,21,15,38,15,0
GER-Bundesliga,2425,Wolfsburg,Salih Özcan,TUR,MF,27-133,1998,3.9,2,2,1,0,1,1,5,20.0,4,5,1,4,7,9,5,0
GER-Bundesliga,2425,Wolfsburg,Sebastiaan Bornauw,BEL,DF,26-063,1999,8.8,9,6,4,4,1,4,8,50.0,4,14,12,2,12,21,36,0
GER-Bundesliga,2425,Wolfsburg,Tiago Tomás,POR,"FW,MF",22-342,2002,20.9,33,19,15,11,7,15,35,42.9,20,17,4,13,9,42,19,0
GER-Bundesliga,2425,Wolfsburg,Yannick Gerhardt,GER,"MF,DF",31-072,1994,16.9,28,16,13,14,1,11,30,36.7,19,32,8,24,17,45,47,0
ITA-Serie A,2425,Atalanta,Ademola Lookman,NGA,"MF,FW",27-216,1997,24.5,32,15,9,15,8,11,19,57.9,8,18,0,18,3,35,5,1
ITA-Serie A,2425,Atalanta,Alberto Manzoni,ITA,MF,19-333,2005,0.1,0,0,0,0,0,0,0,,0,0,0,0,0,0,0,0
ITA-Serie A,2425,Atalanta,Ben Godfrey,ENG,DF,27-129,1998,0.3,0,0,0,0,0,0,1,0.0,1,1,1,0,0,0,0,0
ITA-Serie A,2425,Atalanta,Berat Djimsiti,ALB,DF,32-094,1993,28.3,50,31,27,22,1,28,39,71.8,11,33,20,13,40,90,126,2
ITA-Serie A,2425,Atalanta,Charles De Ketelaere,BEL,"MF,FW",24-075,2001,22.0,12,8,2,8,2,4,15,26.7,11,13,3,10,3,15,9,0
ITA-Serie A,2425,Atalanta,Daniel Maldini,ITA,"FW,MF",23-225,2001,2.4,2,2,0,1,1,1,2,50.0,1,1,0,1,1,3,3,0
ITA-Serie A,2425,Atalanta,Davide Zappacosta,ITA,DF,32-347,1992,23.0,26,16,15,5,6,20,39,51.3,19,28,6,22,11,37,32,2
ITA-Serie A,2425,Atalanta,Federico Cassa,ITA,"MF,FW",19-112,2006,0.2,0,0,0,0,0,0,0,,0,1,0,1,0,0,0,0
ITA-Serie A,2425,Atalanta,Gianluca Scamacca,ITA,FW,26-143,1999,0.1,0,0,0,0,0,0,0,,0,0,0,0,0,0,0,0
ITA-Serie A,2425,Atalanta,Giorgio Scalvini,ITA,DF,21-164,2003,3.0,8,4,5,3,0,5,9,55.6,4,0,0,0,4,12,7,0
ITA-Serie A,2425,Atalanta,Ibrahim Sulemana,GHA,MF,22-002,2003,2.5,8,4,3,5,0,2,6,33.3,4,1,0,1,0,8,1,0
ITA-Serie A,2425,Atalanta,Isak Hien,SWE,DF,26-131,1999,25.9,48,28,27,21,0,27,44,61.4,17,31,18,13,31,79,82,2
ITA-Serie A,2425,Atalanta,Juan Cuadrado,COL,"DF,MF",36-363,1988,9.0,19,9,9,6,4,11,23,47.8,12,14,2,12,7,26,9,0
ITA-Serie A,2425,Atalanta,Juan Musso,ARG,GK,31-018,1994,1.0,0,0,0,0,0,0,0,,0,0,0,0,0,0,0,0
ITA-Serie A,2425,Atalanta,Lazar Samardzic,SRB,MF,23-089,2002,13.0,21,15,5,7,9,12,25,48.0,13,9,1,8,2,23,6,0
ITA-Serie A,2425,Atalanta,Marco Brescianini,ITA,MF,25-124,2000,10.4,18,11,5,9,4,8,10,80.0,2,15,2,13,2,20,6,0
ITA-Serie A,2425,Atalanta,Marco Carnesecchi,ITA,GK,24-327,2000,33.0,0,0,0,0,0,0,0,,0,1,0,1,0,0,25,2
ITA-Serie A,2425,Atalanta,Marco Palestra,ITA,DF,20-082,2005,2.0,5,4,3,2,0,3,3,100.0,0,3,0,3,2,7,4,0
ITA-Serie A,2425,Atalanta,Mario Pašalić,CRO,MF,30-104,1995,21.5,26,16,11,13,2,11,25,44.0,14,21,6,15,12,38,27,1
ITA-Serie A,2425,Atalanta,Marten de Roon,NED,"MF,DF",34-056,1991,34.0,74,48,32,38,4,30,66,45.5,36,40,7,33,47,121,67,1
ITA-Serie A,2425,Atalanta,Mateo Retegui,ITA,FW,26-025,1999,25.5,14,9,0,9,5,3,16,18.8,13,7,0,7,4,18,16,0
ITA-Serie A,2425,Atalanta,Matteo Ruggeri,ITA,DF,22-317,2002,18.5,39,24,15,14,10,25,37,67.6,12,28,3,25,19,58,44,1
ITA-Serie A,2425,Atalanta,Mitchel Bakker,NED,MF,24-338,2000,0.2,1,0,1,0,0,1,1,100.0,0,0,0,0,0,1,0,0
ITA-Serie A,2425,Atalanta,Nicolò Zaniolo,ITA,"FW,MF",25-326,1999,4.0,0,0,0,0,0,0,2,0.0,2,0,0,0,1,1,0,0
ITA-Serie A,2425,Atalanta,Odilon Kossounou,CIV,DF,24-140,2001,11.5,14,9,7,6,1,5,11,45.5,6,14,5,9,12,26,22,1
ITA-Serie A,2425,Atalanta,Rafael Tolói,ITA,DF,34-226,1990,5.2,10,5,3,5,2,4,11,36.4,7,8,2,6,8,18,11,0
ITA-Serie A,2425,Atalanta,Raoul Bellanova,ITA,DF,25-007,2000,25.9,23,13,8,12,3,12,20,60.0,8,12,3,9,18,41,44,0
ITA-Serie A,2425,Atalanta,Rui Patrício,POR,GK,37-098,1988,3.0,0,0,0,0,0,0,0,,0,0,0,0,0,0,3,0
ITA-Serie A,2425,Atalanta,Sead Kolašinac,BIH,DF,31-338,1993,21.1,41,26,21,20,0,16,30,53.3,14,16,7,9,25,66,53,1
ITA-Serie A,2425,Atalanta,Stefan Posch,AUT,DF,28-010,1997,3.8,14,10,5,6,3,7,8,87.5,1,5,1,4,4,18,13,0
ITA-Serie A,2425,Atalanta,Vanja Vlahović,SRB,"FW,MF",21-062,2004,0.7,1,1,0,0,1,0,0,,0,0,0,0,0,1,0,0
ITA-Serie A,2425,Atalanta,Éderson,BRA,MF,25-321,1999,31.6,51,31,18,28,5,22,34,64.7,12,29,6,23,35,86,35,1
ITA-Serie A,2425,Bologna,Benjamín Domínguez,ARG,FW,21-247,2003,14.2,18,7,2,11,5,6,20,30.0,14,15,1,14,4,22,7,0
ITA-Serie A,2425,Bologna,Charalambos Lykogiannis,GRE,DF,31-214,1993,10.8,21,12,13,7,1,10,20,50.0,10,9,5,4,10,31,34,1
ITA-Serie A,2425,Bologna,Dan Ndoye,SUI,FW,24-211,2000,22.8,24,18,8,7,9,14,25,56.0,11,22,0,22,8,32,4,0
ITA-Serie A,2425,Bologna,Davide Calabria,ITA,DF,28-169,1996,6.8,12,8,5,5,2,5,12,41.7,7,4,0,4,2,14,22,1
ITA-Serie A,2425,Bologna,Emil Holm,SWE,DF,25-011,2000,12.1,34,21,17,14,3,20,30,66.7,10,19,4,15,10,44,51,1
ITA-Serie A,2425,Bologna,Estanis,ESP,FW,21-273,2003,0.1,0,0,0,0,0,0,0,,0,0,0,0,0,0,0,0
ITA-Serie A,2425,Bologna,Federico Ravaglia,ITA,GK,25-194,1999,10.7,0,0,0,0,0,0,0,,0,0,0,0,0,0,7,0
ITA-Serie A,2425,Bologna,Giovanni Fabbian,ITA,MF,22-130,2003,11.3,10,6,1,3,6,7,13,53.8,6,7,2,5,2,12,4,0
ITA-Serie A,2425,Bologna,Jens Odgaard,DEN,"MF,FW",26-054,1999,21.7,20,14,3,12,5,6,21,28.6,15,19,2,17,9,29,12,1
ITA-Serie A,2425,Bologna,Jesper Karlsson,SWE,FW,26-303,1998,3.3,1,0,0,0,1,0,2,0.0,2,4,0,4,0,1,3,0
ITA-Serie A,2425,Bologna,Jhon Lucumí,COL,DF,26-332,1998,28.0,51,29,23,28,0,28,40,70.0,12,32,14,18,25,76,87,7
ITA-Serie A,2425,Bologna,Juan Miranda,ESP,DF,25-125,2000,25.3,32,18,11,14,7,14,33,42.4,19,21,3,18,23,55,50,1
ITA-Serie A,2425,Bologna,Kacper Urbanski,POL,MF,20-259,2004,2.7,5,2,4,0,1,4,6,66.7,2,5,1,4,2,7,5,0
ITA-Serie A,2425,Bologna,Lewis Ferguson,SCO,MF,25-273,1999,9.9,21,11,3,13,5,7,13,53.8,6,9,2,7,5,26,9,0
ITA-Serie A,2425,Bologna,Lorenzo De Silvestri,ITA,DF,37-001,1988,11.3,11,6,7,1,3,7,16,43.8,9,12,4,8,10,21,31,0
ITA-Serie A,2425,Bologna,Martin Erlic,CRO,DF,27-120,1998,3.7,2,0,0,2,0,1,2,50.0,1,5,4,1,2,4,9,0
ITA-Serie A,2425,Bologna,Michel Aebischer,SUI,MF,28-138,1997,7.5,17,12,7,7,3,9,13,69.2,4,4,1,3,6,23,6,0
ITA-Serie A,2425,Bologna,Nicolò Cambiaghi,ITA,FW,24-147,2000,6.5,16,10,6,7,3,5,10,50.0,5,9,0,9,2,18,2,0
ITA-Serie A,2425,Bologna,Nicolò Casale,ITA,DF,27-099,1998,9.0,9,4,4,4,1,4,8,50.0,4,14,7,7,14,23,40,2
ITA-Serie A,2425,Bologna,Nikola Moro,CRO,MF,27-073,1998,13.4,35,27,7,21,7,22,33,66.7,11,18,7,11,13,48,18,0
ITA-Serie A,2425,Bologna,Oussama El Azzouzi,MAR,MF,23-360,2001,0.2,0,0,0,0,0,0,0,,0,0,0,0,2,2,0,0
ITA-Serie A,2425,Bologna,Remo Freuler,SUI,MF,33-039,1992,34.7,78,40,28,40,10,33,78,42.3,45,37,4,33,38,116,56,1
ITA-Serie A,2425,Bologna,Riccardo Orsolini,ITA,FW,28-120,1997,19.9,14,12,5,5,4,4,10,40.0,6,25,0,25,8,22,10,1
ITA-Serie A,2425,Bologna,Sam Beukema,NED,DF,26-188,1998,33.5,54,29,27,24,3,22,41,53.7,19,36,21,15,30,84,111,0
ITA-Serie A,2425,Bologna,Samuel Iling-Junior,ENG,"FW,MF",21-232,2003,1.3,3,2,1,1,1,0,1,0.0,1,1,0,1,2,5,2,0
ITA-Serie A,2425,Bologna,Santiago Castro,ARG,FW,20-237,2004,24.9,18,10,4,9,5,6,17,35.3,11,13,2,11,3,21,20,0
ITA-Serie A,2425,Bologna,Stefan Posch,AUT,DF,28-010,1997,7.9,26,15,12,9,5,15,25,60.0,10,19,4,15,5,31,22,0
ITA-Serie A,2425,Bologna,Thijs Dallinga,NED,FW,24-294,2000,12.8,10,5,0,4,6,3,3,100.0,0,10,1,9,1,11,13,1
ITA-Serie A,2425,Bologna,Tommaso Pobega,ITA,MF,25-313,1999,12.6,32,19,12,14,6,21,29,72.4,8,15,4,11,13,45,16,0
ITA-Serie A,2425,Bologna,Łukasz Skorupski,POL,GK,34-019,1991,26.3,1,0,1,0,0,1,3,33.3,2,0,0,0,0,1,13,2
ITA-Serie A,2425,Cagliari,Adam Obert,SVK,DF,22-274,2002,12.0,31,18,12,17,2,16,27,59.3,11,19,7,12,23,54,48,2
ITA-Serie A,2425,Cagliari,Alen Sherri,ALB,GK,27-160,1997,6.9,1,0,1,0,0,1,2,50.0,1,0,0,0,1,2,1,0
ITA-Serie A,2425,Cagliari,Alessandro Deiola,ITA,MF,29-296,1995,15.9,31,20,11,17,3,10,32,31.3,22,26,12,14,13,44,38,0
ITA-Serie A,2425,Cagliari,Antoine Makoumbou,CGO,MF,26-310,1998,23.9,42,23,28,11,3,19,25,76.0,6,26,5,21,17,59,28,0
ITA-Serie A,2425,Cagliari,Elia Caprile,ITA,GK,23-272,2001,18.0,1,0,1,0,0,0,2,0.0,2,0,0,0,0,1,9,1
ITA-Serie A,2425,Cagliari,Florinel Coman,ROU,"FW,MF",27-044,1998,2.9,5,3,3,1,1,2,2,100.0,0,2,0,2,1,6,3,0
ITA-Serie A,2425,Cagliari,Gabriele Zappa,ITA,DF,25-153,1999,34.0,40,23,20,17,3,18,35,51.4,17,42,22,20,23,63,93,1
ITA-Serie A,2425,Cagliari,Gianluca Gaetano,ITA,"MF,FW",25-019,2000,11.2,11,8,4,6,1,5,15,33.3,10,8,0,8,6,17,8,0
ITA-Serie A,2425,Cagliari,Gianluca Lapadula,PER,"FW,MF",35-106,1990,3.4,2,0,1,0,1,0,1,0.0,1,0,0,0,0,2,1,0
ITA-Serie A,2425,Cagliari,Giuseppe Ciocci,ITA,GK,23-120,2002,0.1,0,0,0,0,0,0,0,,0,0,0,0,0,0,0,0
ITA-Serie A,2425,Cagliari,José Luis Palomino,ARG,DF,35-139,1990,12.0,27,15,16,9,2,15,21,71.4,6,21,11,10,22,49,46,0
ITA-Serie A,2425,Cagliari,Kingstone Mutandwa,ZAM,"FW,MF",22-139,2003,1.4,0,0,0,0,0,0,0,,0,0,0,0,0,0,0,0
ITA-Serie A,2425,Cagliari,Leonardo Pavoletti,ITA,"FW,MF",36-179,1988,4.9,1,0,0,1,0,0,0,,0,4,1,3,0,1,3,0
ITA-Serie A,2425,Cagliari,Mateusz Wieteska,POL,DF,28-102,1997,2.0,1,0,0,1,0,1,1,100.0,0,3,2,1,7,8,6,0
ITA-Serie A,2425,Cagliari,Matteo Prati,ITA,MF,21-147,2003,6.3,10,4,2,7,1,3,11,27.3,8,5,2,3,7,17,10,1
ITA-Serie A,2425,Cagliari,Mattia Felici,ITA,"MF,FW",24-037,2001,10.3,17,12,8,7,2,4,11,36.4,7,10,0,10,7,24,7,1
ITA-Serie A,2425,Cagliari,Michel Ndary Adopo,FRA,MF,24-309,2000,26.8,55,32,16,31,8,15,29,51.7,14,20,5,15,27,82,25,0
ITA-Serie A,2425,Cagliari,Nadir Zortea,ITA,"DF,MF",25-339,1999,30.1,30,14,16,12,2,14,37,37.8,23,11,0,11,19,49,47,2
ITA-Serie A,2425,Cagliari,Nicola Pintus,ITA,DF,19-364,2005,0.0,0,0,0,0,0,0,0,,0,0,0,0,0,0,2,0
ITA-Serie A,2425,Cagliari,Nicolas Viola,ITA,"FW,MF",35-224,1989,14.1,14,7,6,7,1,1,10,10.0,9,5,0,5,3,17,5,0
ITA-Serie A,2425,Cagliari,Paulo Azzi,BRA,DF,30-313,1994,4.7,11,9,3,6,2,5,9,55.6,4,5,2,3,5,16,11,0
ITA-Serie A,2425,Cagliari,Roberto Piccoli,ITA,FW,24-117,2001,34.7,13,9,2,6,5,3,12,25.0,9,12,4,8,3,16,31,0
ITA-Serie A,2425,Cagliari,Răzvan Marin,ROU,MF,29-001,1996,15.6,22,13,8,11,3,13,25,52.0,12,7,0,7,2,24,20,2
ITA-Serie A,2425,Cagliari,Sebastiano Luperto,ITA,DF,28-260,1996,36.0,48,27,31,16,1,18,28,64.3,10,29,15,14,33,81,161,1
ITA-Serie A,2425,Cagliari,Simone Scuffet,ITA,GK,28-358,1996,13.0,0,0,0,0,0,0,1,0.0,1,0,0,0,0,0,8,2
ITA-Serie A,2425,Cagliari,Tommaso Augello,ITA,DF,30-267,1994,30.1,49,28,28,17,4,30,43,69.8,13,24,8,16,16,65,109,2
ITA-Serie A,2425,Cagliari,Yerry Mina,COL,DF,30-243,1994,28.5,66,32,43,21,2,40,52,76.9,12,59,35,24,37,103,163,3
ITA-Serie A,2425,Cagliari,Zito Luvumbo,ANG,"FW,MF",23-076,2002,17.8,10,6,4,3,3,6,19,31.6,13,5,0,5,4,14,4,0
ITA-Serie A,2425,Como,Alberto Cerri,ITA,FW,29-038,1996,1.0,0,0,0,0,0,0,0,,0,2,0,2,0,0,1,0
ITA-Serie A,2425,Como,Alberto Dossena,ITA,DF,26-223,1998,20.3,33,20,23,8,2,16,28,57.1,12,22,11,11,22,55,89,1
ITA-Serie A,2425,Como,Alberto Moreno,ESP,DF,32-323,1992,19.2,25,11,17,8,0,12,26,46.2,14,12,3,9,14,39,40,2
ITA-Serie A,2425,Como,Alessandro Gabrielloni,ITA,"FW,MF",30-318,1994,1.6,0,0,0,0,0,0,3,0.0,3,0,0,0,0,0,1,0
ITA-Serie A,2425,Como,Alessio Iovine,ITA,"DF,FW",34-112,1991,4.3,5,2,2,3,0,4,10,40.0,6,7,1,6,3,8,21,1
ITA-Serie A,2425,Como,Ali Jasim,IRQ,"FW,DF",21-124,2004,0.1,1,0,1,0,0,1,1,100.0,0,0,0,0,0,1,0,0
ITA-Serie A,2425,Como,Alieu Fadera,GAM,"FW,DF",23-202,2001,18.3,64,47,25,27,12,20,45,44.4,25,18,1,17,12,76,10,0
ITA-Serie A,2425,Como,Anastasios Douvikas,GRE,FW,25-295,1999,6.4,3,2,0,3,0,1,4,25.0,3,3,0,3,1,4,3,0
ITA-Serie A,2425,Como,Andrea Belotti,ITA,FW,31-155,1993,6.6,7,5,1,4,2,1,4,25.0,3,4,0,4,1,8,8,0
ITA-Serie A,2425,Como,Assane Diao,SEN,"FW,MF",19-259,2005,13.9,25,14,9,10,6,12,28,42.9,16,8,1,7,3,28,19,0
ITA-Serie A,2425,Como,Ben Lhassine Kone,CIV,MF,25-071,2000,0.6,2,2,1,0,1,2,3,66.7,1,0,0,0,1,3,1,0
ITA-Serie A,2425,Como,Daniele Baselli,ITA,MF,33-073,1992,0.2,0,0,0,0,0,0,0,,0,0,0,0,1,1,1,0
ITA-Serie A,2425,Como,Dele Alli,ENG,MF,29-043,1996,0.1,0,0,0,0,0,0,0,,0,0,0,0,0,0,0,0
ITA-Serie A,2425,Como,Edoardo Goldaniga,ITA,DF,31-203,1993,28.1,34,21,21,8,5,13,18,72.2,5,21,10,11,33,67,102,3
ITA-Serie A,2425,Como,Emil Audero,IDN,GK,28-126,1997,8.0,0,0,0,0,0,0,1,0.0,1,0,0,0,0,0,4,1
ITA-Serie A,2425,Como,Federico Barba,ITA,DF,31-265,1993,4.8,2,2,1,1,0,1,4,25.0,3,2,2,0,4,6,15,0
ITA-Serie A,2425,Como,Fellipe Jack,BRA,DF,19-132,2006,1.9,9,4,8,1,0,3,5,60.0,2,2,2,0,4,13,5,0
ITA-Serie A,2425,Como,Gabriel Strefezza,BRA,"FW,MF",28-036,1997,29.1,57,39,20,20,17,21,55,38.2,34,24,2,22,13,70,26,0
ITA-Serie A,2425,Como,Ignace Van Der Brempt,BEL,DF,23-053,2002,14.0,40,32,27,10,3,24,33,72.7,9,13,5,8,16,56,35,0
ITA-Serie A,2425,Como,Ivan Smolčić,CRO,DF,24-280,2000,7.0,16,9,8,7,1,9,13,69.2,4,8,2,6,10,26,24,0
ITA-Serie A,2425,Como,Jean Butez,FRA,GK,29-350,1995,18.5,0,0,0,0,0,0,2,0.0,2,0,0,0,0,0,18,1
ITA-Serie A,2425,Como,Jonathan Ikone,FRA,FW,27-022,1998,6.0,15,9,4,3,8,6,11,54.5,5,5,1,4,0,15,1,1
ITA-Serie A,2425,Como,Luca Mazzitelli,ITA,MF,29-190,1995,3.7,9,6,4,5,0,5,7,71.4,2,5,2,3,3,12,10,0
ITA-Serie A,2425,Como,Lucas Da Cunha,FRA,MF,23-349,2001,29.0,45,25,17,19,9,20,39,51.3,19,18,3,15,17,62,30,1
ITA-Serie A,2425,Como,Marc-Oliver Kempf,GER,DF,30-116,1995,29.1,30,20,15,14,1,13,24,54.2,11,35,26,9,33,63,136,4
ITA-Serie A,2425,Como,Marco Sala,ITA,DF,25-354,1999,2.9,9,6,5,3,1,5,8,62.5,3,2,0,2,1,10,9,0
ITA-Serie A,2425,Como,Matthias Braunöder,AUT,MF,23-058,2002,3.0,10,4,6,3,1,7,11,63.6,4,3,0,3,2,12,4,1
ITA-Serie A,2425,Como,Maxence Caqueret,FRA,MF,25-098,2000,12.1,36,21,14,18,4,20,39,51.3,19,15,1,14,7,43,4,1
ITA-Serie A,2425,Como,Máximo Perrone,ARG,MF,22-137,2003,20.6,38,27,19,14,5,13,38,34.2,25,15,2,13,20,58,43,0
ITA-Serie A,2425,Como,Mërgim Vojvoda,KVX,DF,30-112,1995,8.0,9,6,5,4,0,7,9,77.8,2,7,4,3,4,13,18,0
ITA-Serie A,2425,Como,Nicolás Paz,ARG,"MF,FW",20-258,2004,29.9,51,33,18,26,7,24,51,47.1,27,49,3,46,21,72,16,0
ITA-Serie A,2425,Como,Oliver Abildgaard,DEN,MF,28-348,1996,0.1,0,0,0,0,0,0,0,,0,1,0,1,0,0,0,0
ITA-Serie A,2425,Como,Patrick Cutrone,ITA,FW,27-141,1998,22.7,16,11,0,10,6,7,14,50.0,7,11,0,11,5,21,7,0
ITA-Serie A,2425,Como,Pepe Reina,ESP,GK,42-266,1982,11.5,0,0,0,0,0,0,1,0.0,1,0,0,0,0,0,3,2
ITA-Serie A,2425,Como,Sergi Roberto,ESP,MF,33-106,1992,7.7,14,8,5,5,4,5,7,71.4,2,7,1,6,9,23,14,0
ITA-Serie A,2425,Como,Simone Verdi,ITA,"MF,FW",32-316,1992,1.3,2,2,0,1,1,0,2,0.0,2,2,0,2,0,2,2,0
ITA-Serie A,2425,Como,Yannik Engelhardt,GER,"MF,DF",24-106,2001,12.9,29,12,12,13,4,15,26,57.7,11,13,6,7,11,40,27,0
ITA-Serie A,2425,Como,Álex Valle,ESP,DF,21-029,2004,11.4,26,12,12,12,2,15,21,71.4,6,13,2,11,8,34,42,0
ITA-Serie A,2425,Empoli,Alberto Grassi,ITA,MF,30-078,1995,23.5,39,21,16,18,5,14,21,66.7,7,22,12,10,32,71,43,1
ITA-Serie A,2425,Empoli,Ardian Ismajli,ALB,DF,28-236,1996,26.9,28,22,20,8,0,14,17,82.4,3,33,23,10,55,83,237,3
ITA-Serie A,2425,Empoli,Christian Kouamé,CIV,"FW,MF",27-169,1997,5.6,5,4,0,3,2,2,4,50.0,2,4,2,2,0,5,4,0
ITA-Serie A,2425,Empoli,Devis Vásquez,COL,GK,27-012,1998,31.0,0,0,0,0,0,0,0,,0,0,0,0,0,0,21,4
ITA-Serie A,2425,Empoli,Emmanuel Ekong,SWE,"MF,FW",22-333,2002,2.1,4,3,0,2,2,3,3,100.0,0,2,1,1,1,5,1,0
ITA-Serie A,2425,Empoli,Emmanuel Gyasi,GHA,"DF,FW",31-133,1994,34.9,52,29,32,14,6,24,38,63.2,14,26,9,17,11,63,76,0
ITA-Serie A,2425,Empoli,Faustino Anjorin,ENG,MF,23-182,2001,12.0,27,12,7,14,6,9,18,50.0,9,18,3,15,12,39,20,0
ITA-Serie A,2425,Empoli,Francesco Caputo,ITA,FW,37-291,1987,0.1,0,0,0,0,0,0,0,,0,0,0,0,0,0,0,0
ITA-Serie A,2425,Empoli,Giuseppe Pezzella,ITA,"DF,FW",27-176,1997,31.0,54,30,28,17,9,28,56,50.0,28,31,8,23,15,69,109,1
ITA-Serie A,2425,Empoli,Ismael Konate,CIV,"FW,MF",19-056,2006,1.2,4,2,4,0,0,2,3,66.7,1,3,2,1,0,4,1,0
ITA-Serie A,2425,Empoli,Jacopo Bacci,ITA,MF,19-339,2005,0.3,1,0,1,0,0,1,1,100.0,0,0,0,0,1,2,1,0
ITA-Serie A,2425,Empoli,Jacopo Fazzini,ITA,MF,22-069,2003,14.4,32,19,11,16,5,13,23,56.5,10,13,1,12,6,38,24,0
ITA-Serie A,2425,Empoli,Jacopo Seghetti,ITA,GK,20-096,2005,1.0,0,0,0,0,0,0,0,,0,0,0,0,0,0,0,0
ITA-Serie A,2425,Empoli,Junior Sambia,FRA,"DF,FW",28-259,1996,4.2,13,9,3,5,5,10,10,100.0,0,3,0,3,2,15,5,0
ITA-Serie A,2425,Empoli,Liam Henderson,SCO,MF,29-029,1996,25.3,41,21,17,21,3,21,51,41.2,30,19,5,14,15,56,42,0
ITA-Serie A,2425,Empoli,Liberato Cacace,NZL,"DF,MF",24-239,2000,24.1,37,25,20,13,4,22,31,71.0,9,26,9,17,22,59,59,0
ITA-Serie A,2425,Empoli,Lorenzo Colombo,ITA,"FW,MF",23-077,2002,24.5,31,14,7,16,8,7,21,33.3,14,33,2,31,2,33,16,1
ITA-Serie A,2425,Empoli,Lorenzo Tosto,ITA,DF,19-115,2006,0.0,0,0,0,0,0,0,0,,0,0,0,0,0,0,0,0
ITA-Serie A,2425,Empoli,Luca Marianucci,ITA,DF,20-305,2004,11.9,28,12,17,11,0,11,19,57.9,8,16,8,8,19,47,63,1
ITA-Serie A,2425,Empoli,Marco Silvestri,ITA,GK,34-083,1991,5.0,0,0,0,0,0,0,2,0.0,2,0,0,0,0,0,3,1
ITA-Serie A,2425,Empoli,Mattia De Sciglio,ITA,DF,32-216,1992,8.5,18,13,10,8,0,14,17,82.4,3,10,3,7,8,26,35,1
ITA-Serie A,2425,Empoli,Mattia Viti,ITA,DF,23-120,2002,27.6,65,45,42,20,3,34,51,66.7,17,40,18,22,48,113,120,4
ITA-Serie A,2425,Empoli,Nicolas Haas,SUI,MF,29-121,1996,3.2,11,8,4,5,2,5,9,55.6,4,2,1,1,4,15,6,0
ITA-Serie A,2425,Empoli,Ola Solbakken,NOR,"MF,FW",26-259,1998,8.3,7,4,0,6,1,3,6,50.0,3,0,0,0,2,9,8,0
ITA-Serie A,2425,Empoli,Petar Stojanović,SVN,MF,29-229,1995,0.0,0,0,0,0,0,0,0,,0,0,0,0,0,0,0,0
ITA-Serie A,2425,Empoli,Pietro Pellegri,ITA,FW,24-068,2001,4.6,7,2,0,6,1,2,4,50.0,2,2,0,2,0,7,3,0
ITA-Serie A,2425,Empoli,Saba Goglichidze,GEO,DF,20-333,2004,27.3,63,37,35,25,3,25,50,50.0,25,35,16,19,33,96,94,3
ITA-Serie A,2425,Empoli,Sebastian Walukiewicz,POL,DF,25-049,2000,2.0,1,0,1,0,0,0,1,0.0,1,3,3,0,1,2,15,0
ITA-Serie A,2425,Empoli,Sebastiano Esposito,ITA,"FW,MF",22-326,2002,25.0,57,29,15,31,11,18,35,51.4,17,20,2,18,12,69,14,0
ITA-Serie A,2425,Empoli,Szymon Żurkowski,POL,MF,27-241,1997,1.2,6,4,2,4,0,4,4,100.0,0,3,0,3,1,7,2,0
ITA-Serie A,2425,Empoli,Thomas Campaniello,ITA,FW,17-084,2008,0.3,0,0,0,0,0,0,2,0.0,2,0,0,0,0,0,0,0
ITA-Serie A,2425,Empoli,Tyronne Ebuehi,NGA,"DF,MF",29-159,1995,0.8,3,2,1,2,0,1,1,100.0,0,1,0,1,2,5,0,0
ITA-Serie A,2425,Empoli,Viktor Kovalenko,UKR,MF,29-099,1996,0.9,2,1,0,2,0,0,1,0.0,1,0,0,0,0,2,0,0
ITA-Serie A,2425,Empoli,Youssef Maleh,MAR,MF,26-275,1998,16.8,45,23,17,23,5,17,34,50.0,17,25,6,19,16,61,25,0
ITA-Serie A,2425,Fiorentina,Albert Guðmundsson,ISL,"FW,MF",27-343,1997,13.9,9,5,2,4,3,7,17,41.2,10,5,0,5,6,15,9,1
ITA-Serie A,2425,Fiorentina,Alessandro Bianco,ITA,MF,22-235,2002,0.2,0,0,0,0,0,0,1,0.0,1,0,0,0,0,0,0,0
ITA-Serie A,2425,Fiorentina,Amir Richardson,MAR,MF,23-120,2002,11.4,25,11,12,11,2,9,20,45.0,11,13,1,12,5,30,28,1
ITA-Serie A,2425,Fiorentina,Andrea Colpani,ITA,"FW,MF",26-013,1999,16.1,15,9,5,7,3,4,12,33.3,8,7,0,7,9,24,10,0
ITA-Serie A,2425,Fiorentina,Antonín Barák,CZE,MF,30-172,1994,0.6,2,0,0,2,0,0,2,0.0,2,1,1,0,0,2,0,0
ITA-Serie A,2425,Fiorentina,Cher Ndour,ITA,"MF,DF",20-301,2004,4.4,4,1,2,1,1,2,10,20.0,8,5,1,4,2,6,7,1
ITA-Serie A,2425,Fiorentina,Christian Kouamé,CIV,"FW,MF",27-169,1997,6.9,13,8,4,4,5,0,3,0.0,3,3,1,2,2,15,10,0
ITA-Serie A,2425,Fiorentina,Cristiano Biraghi,ITA,DF,32-265,1992,4.8,4,4,1,3,0,2,7,28.6,5,2,0,2,4,8,11,0
ITA-Serie A,2425,Fiorentina,Danilo Cataldi,ITA,MF,30-291,1994,19.2,25,16,13,10,2,14,27,51.9,13,17,8,9,22,47,35,0
ITA-Serie A,2425,Fiorentina,David de Gea,ESP,GK,34-198,1990,34.0,1,0,1,0,0,1,1,100.0,0,0,0,0,0,1,12,0
ITA-Serie A,2425,Fiorentina,Dodô,BRA,DF,26-188,1998,33.6,44,30,25,11,8,25,48,52.1,23,22,5,17,35,79,58,2
ITA-Serie A,2425,Fiorentina,Edoardo Bove,ITA,"MF,FW",23-008,2002,9.5,24,17,7,14,3,14,28,50.0,14,12,0,12,6,30,8,0
ITA-Serie A,2425,Fiorentina,Fabiano Parisi,ITA,"DF,MF",24-196,2000,12.5,27,17,11,12,4,12,21,57.1,9,14,2,12,17,44,17,0
ITA-Serie A,2425,Fiorentina,Jonathan Ikone,FRA,"FW,MF",27-022,1998,3.7,5,2,3,2,0,2,4,50.0,2,3,0,3,1,6,1,0
ITA-Serie A,2425,Fiorentina,Luca Ranieri,ITA,DF,26-031,1999,33.1,40,22,27,11,2,18,22,81.8,4,45,31,14,28,68,152,1
ITA-Serie A,2425,Fiorentina,Lucas Beltrán,ARG,"FW,MF",24-056,2001,20.8,21,10,8,7,6,6,19,31.6,13,15,2,13,5,26,14,0
ITA-Serie A,2425,Fiorentina,Lucas Martínez Quarta,ARG,DF,29-014,1996,3.9,12,7,9,3,0,8,13,61.5,5,5,2,3,3,15,25,1
ITA-Serie A,2425,Fiorentina,Maat Daniel Caprini,ITA,FW,19-102,2006,0.1,0,0,0,0,0,0,0,,0,0,0,0,0,0,0,0
ITA-Serie A,2425,Fiorentina,Marin Pongračić,CRO,DF,27-255,1997,15.1,18,13,13,4,1,7,11,63.6,4,14,6,8,12,30,69,2
ITA-Serie A,2425,Fiorentina,Matias Moreno,ARG,DF,21-242,2003,1.6,8,8,5,3,0,4,4,100.0,0,5,1,4,1,9,9,0
ITA-Serie A,2425,Fiorentina,Michael Folorunsho,ITA,"FW,MF",27-106,1998,7.2,19,12,9,6,4,8,20,40.0,12,9,1,8,4,23,10,0
ITA-Serie A,2425,Fiorentina,Michael Kayode,ITA,"DF,FW",20-318,2004,1.4,1,1,1,0,0,0,0,,0,3,1,2,2,3,7,0
ITA-Serie A,2425,Fiorentina,Moise Kean,ITA,FW,25-085,2000,29.0,7,5,1,2,4,3,4,75.0,1,12,0,12,6,13,26,1
ITA-Serie A,2425,Fiorentina,Nicolò Fagioli,ITA,MF,24-101,2001,9.7,17,10,8,7,2,9,22,40.9,13,9,1,8,5,22,11,2
ITA-Serie A,2425,Fiorentina,Nicolò Zaniolo,ITA,FW,25-326,1999,3.8,3,1,1,2,0,0,4,0.0,4,2,1,1,0,3,2,0
ITA-Serie A,2425,Fiorentina,Pablo Marí,ESP,DF,31-266,1993,11.2,14,9,11,3,0,6,11,54.5,5,16,11,5,21,35,88,0
ITA-Serie A,2425,Fiorentina,Pietro Comuzzo,ITA,DF,20-093,2005,23.6,42,21,28,11,3,22,28,78.6,6,34,21,13,28,70,108,4
ITA-Serie A,2425,Fiorentina,Pietro Terracciano,ITA,GK,35-077,1990,3.0,0,0,0,0,0,0,0,,0,0,0,0,0,0,0,0
ITA-Serie A,2425,Fiorentina,Riccardo Sottil,ITA,"FW,MF",25-355,1999,9.3,5,4,3,1,1,3,4,75.0,1,1,0,1,4,9,3,0
ITA-Serie A,2425,Fiorentina,Robin Gosens,GER,DF,30-323,1994,27.0,55,32,31,16,8,25,43,58.1,18,31,10,21,18,73,90,0
ITA-Serie A,2425,Fiorentina,Rolando Mandragora,ITA,MF,27-329,1997,20.5,21,11,9,10,2,13,30,43.3,17,22,7,15,16,37,53,1
ITA-Serie A,2425,Fiorentina,Sofyan Amrabat,MAR,MF,28-276,1996,2.0,3,2,1,2,0,2,2,100.0,0,1,1,0,0,3,2,0
ITA-Serie A,2425,Fiorentina,Tommaso Rubino,ITA,MF,18-195,2006,0.1,0,0,0,0,0,0,1,0.0,1,0,0,0,0,0,0,0
ITA-Serie A,2425,Fiorentina,Yacine Adli,FRA,MF,24-299,2000,13.7,32,19,11,16,5,17,39,43.6,22,13,1,12,6,38,19,0
ITA-Serie A,2425,Genoa,Aarón Martín,ESP,DF,28-032,1997,33.3,70,46,40,26,4,32,50,64.0,18,32,10,22,19,89,68,1
ITA-Serie A,2425,Genoa,Alan Matturro,URU,DF,20-225,2004,10.0,11,6,6,5,0,3,14,21.4,11,10,3,7,14,25,38,0
ITA-Serie A,2425,Genoa,Alessandro Marcandalli,ITA,DF,22-241,2002,0.5,1,0,1,0,0,0,0,,0,0,0,0,0,1,2,0
ITA-Serie A,2425,Genoa,Alessandro Vogliacco,ITA,DF,26-252,1998,7.9,15,3,7,7,1,10,12,83.3,2,11,7,4,9,24,20,0
ITA-Serie A,2425,Genoa,Alessandro Zanoli,ITA,"FW,DF",24-233,2000,19.0,29,20,11,14,4,10,23,43.5,13,20,3,17,12,41,40,0
ITA-Serie A,2425,Genoa,Andrea Pinamonti,ITA,FW,26-005,1999,31.7,10,6,0,7,3,2,8,25.0,6,16,4,12,1,11,28,2
ITA-Serie A,2425,Genoa,Benjamin Siegrist,SUI,GK,33-113,1992,1.0,0,0,0,0,0,0,0,,0,0,0,0,0,0,1,0
ITA-Serie A,2425,Genoa,Brooke Norton-Cuffy,ENG,"DF,FW",21-132,2004,7.1,12,7,9,3,0,9,10,90.0,1,10,1,9,3,15,12,0
ITA-Serie A,2425,Genoa,Caleb Ekuban,GHA,FW,31-062,1994,5.9,3,3,1,1,1,1,1,100.0,0,4,1,3,1,4,5,0
ITA-Serie A,2425,Genoa,David Akpan Ankeye,NGA,"FW,MF",23-099,2002,0.5,0,0,0,0,0,0,1,0.0,1,0,0,0,0,0,1,0
ITA-Serie A,2425,Genoa,Emil Bohinen,NOR,MF,26-073,1999,1.8,4,4,3,0,1,2,5,40.0,3,2,0,2,1,5,6,0
ITA-Serie A,2425,Genoa,Fabio Miretti,ITA,"MF,FW",21-294,2003,18.6,28,15,6,14,8,18,33,54.5,15,20,1,19,7,35,13,2
ITA-Serie A,2425,Genoa,Federico Accornero,ITA,MF,21-108,2004,0.1,0,0,0,0,0,0,0,,0,0,0,0,0,0,0,0
ITA-Serie A,2425,Genoa,Filippo Melegoni,ITA,"MF,FW",26-095,1999,1.0,1,1,1,0,0,0,4,0.0,4,0,0,0,0,1,2,0
ITA-Serie A,2425,Genoa,Gastón Pereiro,URU,MF,29-347,1995,0.3,1,0,0,1,0,1,1,100.0,0,0,0,0,0,1,1,0
ITA-Serie A,2425,Genoa,Honest Ahanor,ITA,"DF,MF",17-090,2008,3.0,7,5,2,3,2,7,10,70.0,3,4,0,4,1,8,9,0
ITA-Serie A,2425,Genoa,Jean Onana,CMR,MF,25-136,2000,2.4,9,6,2,7,0,4,7,57.1,3,3,0,3,2,11,8,1
ITA-Serie A,2425,Genoa,Jeff Ekhator,ITA,"FW,MF",18-194,2006,8.2,7,4,4,1,2,4,8,50.0,4,10,1,9,2,9,5,0
ITA-Serie A,2425,Genoa,Johan Vásquez,MEX,DF,26-214,1998,33.8,56,31,24,27,5,26,44,59.1,18,59,31,28,50,106,150,1
ITA-Serie A,2425,Genoa,Junior Messias,BRA,"MF,FW",34-011,1991,8.4,12,7,6,5,1,3,8,37.5,5,7,2,5,6,18,15,0
ITA-Serie A,2425,Genoa,Koni De Winter,BEL,DF,22-346,2002,22.7,33,19,21,8,4,17,24,70.8,7,10,6,4,23,56,109,3
ITA-Serie A,2425,Genoa,Lior Kasa,ISR,"MF,FW",19-239,2005,2.6,4,4,2,2,0,2,5,40.0,3,4,1,3,3,7,5,0
ITA-Serie A,2425,Genoa,Lorenzo Venturino,ITA,"FW,MF",18-336,2006,1.2,3,2,2,0,1,1,3,33.3,2,1,0,1,0,3,3,0
ITA-Serie A,2425,Genoa,Mario Balotelli,ITA,"FW,MF",34-285,1990,0.7,0,0,0,0,0,0,0,,0,0,0,0,0,0,1,0
ITA-Serie A,2425,Genoa,Mattia Bani,ITA,DF,31-165,1993,16.1,18,9,11,5,2,7,11,63.6,4,13,8,5,20,38,80,2
ITA-Serie A,2425,Genoa,Maxwel Cornet,CIV,"FW,MF",28-239,1996,2.6,2,1,1,0,1,0,1,0.0,1,1,1,0,2,4,1,0
ITA-Serie A,2425,Genoa,Milan Badelj,CRO,MF,36-088,1989,16.4,29,16,14,10,5,15,35,42.9,20,19,7,12,20,49,43,0
ITA-Serie A,2425,Genoa,Morten Frendrup,DEN,MF,24-047,2001,34.5,102,61,23,52,27,34,78,43.6,44,62,16,46,47,149,57,0
ITA-Serie A,2425,Genoa,Morten Thorsby,NOR,"MF,FW",29-019,1996,21.1,49,30,19,20,10,17,29,58.6,12,22,1,21,5,54,28,1
ITA-Serie A,2425,Genoa,Nicola Leali,ITA,GK,32-096,1993,29.0,0,0,0,0,0,0,0,,0,0,0,0,0,0,14,1
ITA-Serie A,2425,Genoa,Patrizio Masini,ITA,MF,24-117,2001,16.1,51,28,18,23,10,19,40,47.5,21,24,7,17,13,64,37,0
ITA-Serie A,2425,Genoa,Pierluigi Gollini,ITA,GK,30-067,1995,7.0,0,0,0,0,0,0,0,,0,1,0,1,0,0,2,1
ITA-Serie A,2425,Genoa,Ruslan Malinovskyi,UKR,"MF,FW",32-020,1993,4.3,12,8,4,7,1,3,6,50.0,3,2,0,2,1,13,4,0
ITA-Serie A,2425,Genoa,Sebastian Otoa,DEN,DF,21-011,2004,1.0,0,0,0,0,0,0,1,0.0,1,0,0,0,1,1,5,0
ITA-Serie A,2425,Genoa,Stefano Sabelli,ITA,DF,32-131,1993,22.6,57,31,26,25,6,19,51,37.3,32,28,7,21,22,79,62,0
ITA-Serie A,2425,Genoa,Vitinha,POR,"FW,MF",25-070,2000,14.1,22,7,12,5,5,11,29,37.9,18,13,2,11,11,33,21,0
ITA-Serie A,2425,Hellas Verona,Abdou Harroui,NED,"MF,FW",27-131,1998,5.1,9,6,6,3,0,4,4,100.0,0,5,0,5,2,11,5,0
ITA-Serie A,2425,Hellas Verona,Alphadjo Cissè,ITA,"FW,MF",18-214,2006,0.1,0,0,0,0,0,0,0,,0,0,0,0,0,0,0,0
ITA-Serie A,2425,Hellas Verona,Amin Sarr,SWE,FW,24-074,2001,20.5,22,12,3,8,11,5,10,50.0,5,17,3,14,3,25,14,0
ITA-Serie A,2425,Hellas Verona,Antoine Bernede,FRA,MF,25-363,1999,6.5,15,8,4,9,2,10,16,62.5,6,6,1,5,5,20,3,0
ITA-Serie A,2425,Hellas Verona,Casper Tengstedt,DEN,FW,24-357,2000,16.9,7,5,0,5,2,4,9,44.4,5,5,1,4,4,11,29,0
ITA-Serie A,2425,Hellas Verona,Cheikh Tidiane Niasse,SEN,MF,25-125,2000,8.4,18,15,6,12,0,10,19,52.6,9,17,4,13,17,35,17,2
ITA-Serie A,2425,Hellas Verona,Dailon Livramento,CPV,"FW,MF",24-020,2001,10.1,13,9,2,5,6,6,12,50.0,6,9,2,7,3,16,8,0
ITA-Serie A,2425,Hellas Verona,Daniel Bandeira,POR,MF,25-043,2000,4.5,4,0,1,3,0,3,6,50.0,3,2,1,1,6,10,8,0
ITA-Serie A,2425,Hellas Verona,Daniel Mosquera,COL,FW,25-216,1999,14.9,10,7,3,4,3,1,14,7.1,13,11,1,10,2,12,9,0
ITA-Serie A,2425,Hellas Verona,Daniel Oyegoke,ENG,DF,22-141,2003,1.1,2,2,1,0,1,1,1,100.0,0,1,0,1,1,3,7,0
ITA-Serie A,2425,Hellas Verona,Daniele Ghilardi,ITA,DF,22-138,2003,21.5,40,25,25,15,0,23,39,59.0,16,28,14,14,28,68,97,0
ITA-Serie A,2425,Hellas Verona,Darko Lazović,SRB,"DF,MF",34-251,1990,16.2,21,10,5,14,2,11,28,39.3,17,19,3,16,11,32,39,0
ITA-Serie A,2425,Hellas Verona,Davide Faraoni,ITA,DF,33-211,1991,2.9,10,9,5,5,0,3,9,33.3,6,7,3,4,2,12,12,1
ITA-Serie A,2425,Hellas Verona,Diego Coppola,ITA,DF,21-147,2003,31.5,65,35,47,14,4,27,39,69.2,12,42,24,18,71,136,175,2
ITA-Serie A,2425,Hellas Verona,Domagoj Bradarić,CRO,DF,25-165,1999,20.6,35,27,20,11,4,18,29,62.1,11,17,4,13,15,50,46,1
ITA-Serie A,2425,Hellas Verona,Faride Alidou,GER,"FW,MF",23-310,2001,0.8,0,0,0,0,0,0,0,,0,1,0,1,1,1,3,1
ITA-Serie A,2425,Hellas Verona,Flavius Daniliuc,AUT,DF,24-027,2001,11.2,26,21,14,9,3,15,24,62.5,9,10,3,7,7,33,27,0
ITA-Serie A,2425,Hellas Verona,Giangiacomo Magnani,ITA,DF,29-232,1995,11.8,20,15,14,6,0,7,7,100.0,0,16,9,7,17,37,73,1
ITA-Serie A,2425,Hellas Verona,Grigoris Kastanos,CYP,"MF,FW",27-114,1998,9.7,23,16,8,7,8,9,21,42.9,12,17,2,15,7,30,8,0
ITA-Serie A,2425,Hellas Verona,Jackson Tchatchoua,CMR,"DF,MF",23-252,2001,34.2,50,31,34,13,3,28,43,65.1,15,21,9,12,13,63,70,2
ITA-Serie A,2425,Hellas Verona,Junior Ajayi,CIV,FW,20-225,2004,0.1,0,0,0,0,0,0,0,,0,0,0,0,0,0,0,0
ITA-Serie A,2425,Hellas Verona,Lorenzo Montipò,ITA,GK,29-093,1996,36.0,1,0,1,0,0,1,4,25.0,3,0,0,0,0,1,24,4
ITA-Serie A,2425,Hellas Verona,Martin Frese,DEN,DF,27-140,1998,6.0,17,10,6,10,1,6,11,54.5,5,5,1,4,8,25,16,1
ITA-Serie A,2425,Hellas Verona,Mathis Lambourde,FRA,"FW,MF",19-135,2006,1.0,3,1,2,1,0,1,3,33.3,2,3,0,3,0,3,1,0
ITA-Serie A,2425,Hellas Verona,Nicolás Valentini,ARG,DF,24-048,2001,11.5,33,22,21,11,1,19,28,67.9,9,12,6,6,14,47,82,0
ITA-Serie A,2425,Hellas Verona,Ondrej Duda,SVK,MF,30-170,1994,25.6,44,26,20,21,3,29,62,46.8,33,26,8,18,31,75,30,4
ITA-Serie A,2425,Hellas Verona,Paweł Dawidowicz,POL,"DF,MF",30-004,1995,19.5,44,23,20,21,3,18,27,66.7,9,15,5,10,20,64,63,2
ITA-Serie A,2425,Hellas Verona,Reda Belahyane,MAR,MF,20-357,2004,18.4,36,26,16,13,7,13,17,76.5,4,20,9,11,10,46,22,1
ITA-Serie A,2425,Hellas Verona,Simone Perilli,ITA,GK,30-137,1995,1.0,0,0,0,0,0,0,0,,0,0,0,0,0,0,1,0
ITA-Serie A,2425,Hellas Verona,Suat Serdar,GER,MF,28-043,1997,14.4,32,19,11,18,3,9,24,37.5,15,19,4,15,8,40,19,0
ITA-Serie A,2425,Hellas Verona,Tomáš Suslov,SVK,"MF,FW",22-351,2002,22.5,52,36,21,24,7,21,69,30.4,48,29,2,27,18,70,17,1
ITA-Serie A,2425,Hellas Verona,Yllan Okou,FRA,DF,22-152,2002,0.0,0,0,0,0,0,0,0,,0,1,0,1,0,0,0,0
ITA-Serie A,2425,Inter,Alessandro Bastoni,ITA,DF,26-041,1999,26.7,46,24,26,14,6,20,30,66.7,10,25,13,12,22,68,52,1
ITA-Serie A,2425,Inter,Benjamin Pavard,FRA,DF,29-057,1996,17.6,29,16,12,12,5,18,25,72.0,7,16,12,4,16,45,52,0
ITA-Serie A,2425,Inter,Carlos Augusto,BRA,DF,26-137,1999,18.8,29,14,12,11,6,12,19,63.2,7,21,9,12,9,38,49,0
ITA-Serie A,2425,Inter,Davide Frattesi,ITA,MF,25-214,1999,13.6,17,8,6,10,1,10,18,55.6,8,12,4,8,5,22,14,1
ITA-Serie A,2425,Inter,Denzel Dumfries,NED,"DF,FW",29-036,1996,21.7,25,18,12,9,4,14,27,51.9,13,31,8,23,6,31,26,1
ITA-Serie A,2425,Inter,Federico Dimarco,ITA,"DF,FW",27-195,1997,24.2,25,14,10,12,3,10,19,52.6,9,24,4,20,14,39,33,2
ITA-Serie A,2425,Inter,Francesco Acerbi,ITA,DF,37-103,1988,19.0,23,19,16,7,0,11,17,64.7,6,22,16,6,26,49,81,0
ITA-Serie A,2425,Inter,Hakan Çalhanoğlu,TUR,MF,31-105,1994,21.6,43,23,7,23,13,21,36,58.3,15,17,8,9,18,61,24,0
ITA-Serie A,2425,Inter,Henrikh Mkhitaryan,ARM,MF,36-123,1989,26.6,43,24,17,16,10,20,45,44.4,25,29,5,24,17,60,41,0
ITA-Serie A,2425,Inter,Joaquín Correa,ARG,"FW,MF",30-284,1994,8.1,11,5,4,7,0,4,13,30.8,9,3,0,3,0,11,6,0
ITA-Serie A,2425,Inter,Josep Martinez,ESP,GK,26-362,1998,5.0,0,0,0,0,0,0,0,,0,0,0,0,0,0,0,0
ITA-Serie A,2425,Inter,Kristjan Asllani,ALB,MF,23-076,2002,11.0,14,3,8,4,2,8,22,36.4,14,8,1,7,9,23,13,1
ITA-Serie A,2425,Inter,Lautaro Martínez,ARG,FW,27-275,1997,28.5,30,16,10,12,8,13,25,52.0,12,21,3,18,10,40,15,0
ITA-Serie A,2425,Inter,Luka Topalović,SVN,MF,19-090,2006,0.1,1,1,0,1,0,0,0,,0,0,0,0,0,1,0,0
ITA-Serie A,2425,Inter,Marcus Thuram,FRA,FW,27-291,1997,25.4,18,10,7,5,6,3,14,21.4,11,16,3,13,3,21,15,0
ITA-Serie A,2425,Inter,Marko Arnautović,AUT,FW,36-035,1989,6.1,7,6,1,3,3,3,5,60.0,2,3,0,3,1,8,1,0
ITA-Serie A,2425,Inter,Matteo Darmian,ITA,DF,35-173,1989,19.8,28,17,12,12,4,14,25,56.0,11,14,6,8,10,38,39,0
ITA-Serie A,2425,Inter,Mehdi Taremi,IRN,FW,32-310,1992,9.1,7,1,2,2,3,1,4,25.0,3,11,2,9,0,7,11,0
ITA-Serie A,2425,Inter,Nicola Zalewski,POL,"DF,MF",23-121,2002,4.8,7,4,3,2,2,4,6,66.7,2,5,1,4,2,9,5,1
ITA-Serie A,2425,Inter,Nicolò Barella,ITA,MF,28-106,1997,27.7,50,31,19,20,11,26,59,44.1,33,26,3,23,12,62,16,1
ITA-Serie A,2425,Inter,Piotr Zieliński,POL,MF,31-004,1994,10.9,14,10,6,7,1,6,13,46.2,7,10,5,5,6,20,13,1
ITA-Serie A,2425,Inter,Stefan de Vrij,NED,DF,33-108,1992,19.2,18,12,12,5,1,9,12,75.0,3,19,11,8,23,41,89,0
ITA-Serie A,2425,Inter,Tajon Buchanan,CAN,"DF,FW",26-105,1999,1.1,3,0,2,0,1,1,2,50.0,1,0,0,0,0,3,3,0
ITA-Serie A,2425,Inter,Tomás Palacios,ARG,DF,22-026,2003,0.1,0,0,0,0,0,0,0,,0,0,0,0,1,1,0,0
ITA-Serie A,2425,Inter,Yann Aurel Bisseck,GER,DF,24-176,2000,18.3,17,12,11,4,2,11,16,68.8,5,23,12,11,17,34,64,1
ITA-Serie A,2425,Inter,Yann Sommer,SUI,GK,36-158,1988,33.0,0,0,0,0,0,0,0,,0,0,0,0,0,0,13,1
ITA-Serie A,2425,Juventus,Alberto costa,POR,DF,21-237,2003,3.5,13,9,6,5,2,6,8,75.0,2,5,1,4,4,17,10,0
ITA-Serie A,2425,Juventus,Andrea Cambiaso,ITA,"DF,FW",25-093,2000,23.8,43,28,26,11,6,26,42,61.9,16,23,4,19,15,58,34,5
ITA-Serie A,2425,Juventus,Danilo,BRA,DF,33-313,1991,6.5,10,4,7,2,1,5,10,50.0,5,4,3,1,9,19,21,1
ITA-Serie A,2425,Juventus,Diego Pugno,ITA,FW,18-321,2006,0.1,0,0,0,0,0,0,0,,0,0,0,0,0,0,0,0
ITA-Serie A,2425,Juventus,Douglas Luiz,BRA,MF,27-015,1998,5.9,13,8,7,5,1,6,9,66.7,3,5,2,3,4,17,5,0
ITA-Serie A,2425,Juventus,Dušan Vlahović,SRB,FW,25-116,2000,19.7,3,1,0,1,2,1,5,20.0,4,7,3,4,1,4,9,3
ITA-Serie A,2425,Juventus,Federico Gatti,ITA,DF,26-334,1998,24.3,28,23,18,8,2,14,24,58.3,10,27,18,9,18,46,74,2
ITA-Serie A,2425,Juventus,Francisco Conceição,POR,"FW,MF",22-161,2002,13.9,22,13,6,8,8,12,29,41.4,17,7,0,7,5,27,6,0
ITA-Serie A,2425,Juventus,Gleison Bremer,BRA,DF,28-067,1997,6.0,15,7,9,5,1,4,5,80.0,1,15,11,4,6,21,16,0
ITA-Serie A,2425,Juventus,Jonas Rouhi,SWE,DF,21-137,2004,2.3,4,1,1,3,0,0,1,0.0,1,2,0,2,3,7,2,0
ITA-Serie A,2425,Juventus,Juan David Cabal,COL,DF,24-136,2001,5.1,10,4,7,3,0,8,12,66.7,4,2,0,2,2,12,14,1
ITA-Serie A,2425,Juventus,Kenan Yıldız,TUR,"FW,MF",20-020,2005,25.7,52,29,11,26,15,16,30,53.3,14,24,0,24,5,57,12,3
ITA-Serie A,2425,Juventus,Khéphren Thuram,FRA,MF,24-059,2001,24.8,39,18,13,22,4,18,30,60.0,12,31,9,22,12,51,37,1
ITA-Serie A,2425,Juventus,Lloyd Kelly,ENG,DF,26-230,1998,10.3,10,8,3,6,1,7,9,77.8,2,10,6,4,2,12,51,3
ITA-Serie A,2425,Juventus,Lorenzo Anghelè,ITA,FW,20-087,2005,0.1,0,0,0,0,0,0,0,,0,0,0,0,0,0,0,0
ITA-Serie A,2425,Juventus,Manuel Locatelli,ITA,MF,27-136,1998,30.4,69,47,28,34,7,30,50,60.0,20,55,19,36,23,92,74,0
ITA-Serie A,2425,Juventus,Mattia Perin,ITA,GK,32-195,1992,5.0,0,0,0,0,0,0,0,,0,0,0,0,0,0,2,0
ITA-Serie A,2425,Juventus,Michele Di Gregorio,ITA,GK,27-301,1997,32.0,0,0,0,0,0,0,0,,0,0,0,0,0,0,14,0
ITA-Serie A,2425,Juventus,Nicolás González,ARG,"FW,MF",27-048,1998,18.6,24,13,10,9,5,9,25,36.0,16,16,4,12,9,33,30,2
ITA-Serie A,2425,Juventus,Nicolò Fagioli,ITA,MF,24-101,2001,6.3,14,10,7,6,1,6,9,66.7,3,4,0,4,2,16,5,0
ITA-Serie A,2425,Juventus,Nicolò Savona,ITA,DF,22-066,2003,18.2,29,13,19,9,1,13,24,54.2,11,10,2,8,10,39,33,0
ITA-Serie A,2425,Juventus,Pierre Kalulu,FRA,DF,24-353,2000,26.0,41,25,29,9,3,18,24,75.0,6,27,15,12,17,58,68,1
ITA-Serie A,2425,Juventus,Randal Kolo Muani,FRA,FW,26-170,1998,12.1,11,7,3,5,3,4,5,80.0,1,7,0,7,3,14,2,0
ITA-Serie A,2425,Juventus,Renato Veiga,POR,DF,21-299,2003,11.6,17,12,7,9,1,9,14,64.3,5,16,13,3,17,34,77,0
ITA-Serie A,2425,Juventus,Samuel Mbangula,BEL,FW,21-128,2004,7.9,15,10,7,6,2,7,13,53.8,6,7,0,7,3,18,4,0
ITA-Serie A,2425,Juventus,Teun Koopmeiners,NED,"MF,FW",27-085,1998,22.2,32,16,6,19,7,10,30,33.3,20,36,14,22,8,40,26,2
ITA-Serie A,2425,Juventus,Timothy Weah,USA,"DF,FW",25-091,2000,18.1,35,19,15,12,8,14,25,56.0,11,25,4,21,14,49,27,2
ITA-Serie A,2425,Juventus,Vasilije Adžić,MNE,"MF,FW",19-012,2006,0.5,2,2,0,1,1,0,1,0.0,1,0,0,0,0,2,0,0
ITA-Serie A,2425,Juventus,Weston McKennie,USA,"MF,DF",26-269,1998,25.5,33,12,18,11,4,13,22,59.1,9,28,8,20,14,47,37,0
ITA-Serie A,2425,Lazio,Adam Marušić,MNE,DF,32-219,1992,25.5,31,19,17,12,2,17,29,58.6,12,18,8,10,16,47,60,0
ITA-Serie A,2425,Lazio,Alessio Romagnoli,ITA,DF,30-132,1995,28.7,48,29,20,26,2,22,27,81.5,5,32,16,16,25,73,114,1
ITA-Serie A,2425,Lazio,Arijon Ibrahimović,GER,MF,19-164,2005,0.1,0,0,0,0,0,0,0,,0,0,0,0,0,0,0,0
ITA-Serie A,2425,Lazio,Boulaye Dia,SEN,"MF,FW",28-189,1996,23.2,22,10,5,12,5,7,16,43.8,9,12,1,11,5,27,16,1
ITA-Serie A,2425,Lazio,Christos Mandas,GRE,GK,23-249,2001,8.0,0,0,0,0,0,0,0,,0,0,0,0,0,0,3,0
ITA-Serie A,2425,Lazio,Elseid Hysaj,ALB,DF,31-093,1994,4.2,11,6,6,5,0,3,3,100.0,0,3,2,1,5,16,19,0
ITA-Serie A,2425,Lazio,Fisayo Dele-Bashiru,NGA,"MF,FW",24-107,2001,10.5,10,6,3,3,4,2,6,33.3,4,10,2,8,4,14,5,0
ITA-Serie A,2425,Lazio,Gaetano Castrovilli,ITA,"MF,FW",28-096,1997,1.6,5,2,3,1,1,2,4,50.0,2,3,0,3,3,8,1,0
ITA-Serie A,2425,Lazio,Gustav Isaksen,DEN,FW,24-035,2001,24.1,16,9,7,8,1,7,28,25.0,21,21,2,19,9,25,21,1
ITA-Serie A,2425,Lazio,Ivan Provedel,ITA,GK,31-068,1994,29.0,0,0,0,0,0,0,0,,0,1,0,1,1,1,12,3
ITA-Serie A,2425,Lazio,Loum Tchaouna,FRA,"FW,MF",21-258,2003,7.3,8,4,2,2,4,3,9,33.3,6,5,1,4,4,12,14,2
ITA-Serie A,2425,Lazio,Luca Pellegrini,ITA,DF,26-078,1999,11.7,22,11,10,10,2,16,31,51.6,15,10,3,7,19,41,31,0
ITA-Serie A,2425,Lazio,Manuel Lazzari,ITA,DF,31-176,1993,15.6,26,16,13,11,2,14,24,58.3,10,9,5,4,10,36,19,0
ITA-Serie A,2425,Lazio,Mario Gila,ESP,DF,24-268,2000,29.5,53,36,33,18,2,36,53,67.9,17,19,13,6,28,81,112,3
ITA-Serie A,2425,Lazio,Mattia Zaccagni,ITA,FW,29-342,1995,29.0,37,26,13,20,4,15,30,50.0,15,17,1,16,29,66,21,2
ITA-Serie A,2425,Lazio,Mattéo Guendouzi,FRA,MF,26-040,1999,35.3,36,20,12,19,5,20,46,43.5,26,33,9,24,31,67,48,2
ITA-Serie A,2425,Lazio,Matías Vecino,URU,MF,33-273,1991,9.6,13,7,3,9,1,4,18,22.2,14,8,3,5,5,18,15,0
ITA-Serie A,2425,Lazio,Nicolò Casale,ITA,DF,27-099,1998,1.5,5,3,4,1,0,0,0,,0,4,3,1,1,6,2,0
ITA-Serie A,2425,Lazio,Nicolò Rovella,ITA,MF,23-171,2001,29.4,82,48,38,37,7,40,77,51.9,37,19,4,15,47,129,46,3
ITA-Serie A,2425,Lazio,Nuno Tavares,POR,DF,25-118,2000,17.9,28,21,15,8,5,14,33,42.4,19,20,3,17,20,48,42,1
ITA-Serie A,2425,Lazio,Oliver Nielsen,DEN,DF,21-354,2003,0.4,0,0,0,0,0,0,0,,0,1,0,1,1,1,2,0
ITA-Serie A,2425,Lazio,Patric,ESP,DF,32-037,1993,6.7,9,6,6,3,0,6,10,60.0,4,3,2,1,3,12,22,1
ITA-Serie A,2425,Lazio,Pedro,ESP,"FW,MF",37-300,1987,11.7,19,14,5,9,5,10,21,47.6,11,11,0,11,3,22,3,1
ITA-Serie A,2425,Lazio,Reda Belahyane,MAR,MF,20-357,2004,2.2,8,6,8,0,0,6,6,100.0,0,3,2,1,1,9,5,0
ITA-Serie A,2425,Lazio,Samuel Gigot,FRA,DF,31-224,1993,7.6,4,3,1,3,0,0,1,0.0,1,8,6,2,13,17,36,0
ITA-Serie A,2425,Lazio,Tijjani Noslin,NED,"FW,MF",25-321,1999,9.4,6,5,2,1,3,1,8,12.5,7,15,1,14,1,7,7,0
ITA-Serie A,2425,Lazio,Valentín Castellanos,ARG,FW,26-233,1998,25.5,13,6,2,4,7,1,10,10.0,9,18,2,16,5,18,24,0
ITA-Serie A,2425,Lecce,Andy Pelmard,FRA,DF,25-073,2000,1.4,6,6,5,1,0,4,4,100.0,0,1,0,1,0,6,5,0
ITA-Serie A,2425,Lecce,Ante Rebić,CRO,"FW,MF",31-245,1993,8.8,12,9,5,5,2,3,9,33.3,6,7,1,6,2,14,4,1
ITA-Serie A,2425,Lecce,Antonino Gallo,ITA,DF,25-139,2000,28.0,64,41,45,15,4,33,60,55.0,27,31,4,27,20,84,124,0
ITA-Serie A,2425,Lecce,Balthazar Pierret,FRA,MF,25-009,2000,19.1,51,31,25,23,3,13,30,43.3,17,19,5,14,19,70,31,1
ITA-Serie A,2425,Lecce,Danilo Veiga,POR,DF,22-241,2002,4.0,8,6,4,4,0,6,12,50.0,6,5,0,5,4,12,10,0
ITA-Serie A,2425,Lecce,Federico Baschirotto,ITA,DF,28-246,1996,37.0,37,25,30,5,2,22,28,78.6,6,44,32,12,23,60,219,2
ITA-Serie A,2425,Lecce,Filip Marchwiński,POL,MF,23-134,2002,0.2,0,0,0,0,0,0,0,,0,0,0,0,0,0,0,0
ITA-Serie A,2425,Lecce,Frederic Guilbert,FRA,DF,30-151,1994,26.1,64,35,29,29,6,35,54,64.8,19,27,8,19,46,110,104,3
ITA-Serie A,2425,Lecce,Gaby Jean,FRA,DF,25-094,2000,15.4,14,7,8,5,1,6,11,54.5,5,13,10,3,9,23,71,1
ITA-Serie A,2425,Lecce,Hamza Rafia,TUN,MF,26-052,1999,11.8,44,27,14,25,5,15,32,46.9,17,7,2,5,4,48,18,1
ITA-Serie A,2425,Lecce,Jesper Karlsson,SWE,FW,26-303,1998,4.9,3,2,3,0,0,2,8,25.0,6,1,0,1,0,3,3,0
ITA-Serie A,2425,Lecce,Kevin Bonifazi,ITA,DF,29-005,1996,0.7,1,1,1,0,0,1,1,100.0,0,1,1,0,2,3,3,0
ITA-Serie A,2425,Lecce,Kialonda,ANG,DF,27-239,1997,22.8,34,12,24,10,0,12,17,70.6,5,43,27,16,30,64,120,1
ITA-Serie A,2425,Lecce,Konan N'dri,CIV,"FW,MF",24-209,2000,3.4,3,3,0,0,3,2,3,66.7,1,4,0,4,1,4,0,0
ITA-Serie A,2425,Lecce,Lameck Banda,ZAM,"FW,MF",24-115,2001,6.8,8,5,4,2,2,3,12,25.0,9,7,0,7,2,10,8,1
ITA-Serie A,2425,Lecce,Lassana Coulibaly,MLI,MF,29-044,1996,28.6,47,29,16,28,3,23,60,38.3,37,42,12,30,18,65,42,1
ITA-Serie A,2425,Lecce,Marco Sala,ITA,DF,25-354,1999,0.8,1,0,0,1,0,0,1,0.0,1,1,0,1,0,1,0,0
ITA-Serie A,2425,Lecce,Medon Berisha,ALB,MF,21-215,2003,7.3,12,8,7,3,2,4,8,50.0,4,6,0,6,10,22,4,2
ITA-Serie A,2425,Lecce,Mohamed Kaba,FRA,MF,23-209,2001,4.7,13,8,7,5,1,8,9,88.9,1,10,3,7,4,17,9,1
ITA-Serie A,2425,Lecce,Nicola Sansone,ITA,"MF,FW",33-256,1991,0.7,0,0,0,0,0,0,0,,0,0,0,0,0,0,0,0
ITA-Serie A,2425,Lecce,Nikola Krstović,MNE,FW,25-049,2000,33.0,17,8,4,6,7,6,15,40.0,9,10,6,4,7,24,22,0
ITA-Serie A,2425,Lecce,Patrick Dorgu,DEN,"DF,FW",20-210,2004,20.4,45,27,21,19,5,23,45,51.1,22,24,6,18,18,63,42,2
ITA-Serie A,2425,Lecce,Rareș-Cătălin Burnete,ROU,FW,21-113,2004,0.3,0,0,0,0,0,0,1,0.0,1,0,0,0,0,0,0,0
ITA-Serie A,2425,Lecce,Remi Oudin,FRA,"MF,FW",28-187,1996,3.3,3,1,1,1,1,2,4,50.0,2,6,2,4,2,5,1,0
ITA-Serie A,2425,Lecce,Santiago Pierotti,ARG,FW,24-051,2001,21.0,45,24,21,18,6,22,48,45.8,26,29,5,24,14,59,30,0
ITA-Serie A,2425,Lecce,Tete Morente,ESP,"FW,MF",28-171,1996,22.5,27,17,10,11,6,10,36,27.8,26,16,1,15,14,41,31,1
ITA-Serie A,2425,Lecce,Tiago Gabriel,POR,DF,20-149,2004,1.1,0,0,0,0,0,0,0,,0,4,2,2,0,0,11,0
ITA-Serie A,2425,Lecce,Valentin Gendrey,FRA,DF,24-337,2000,2.0,2,2,1,0,1,1,1,100.0,0,3,1,2,2,4,1,0
ITA-Serie A,2425,Lecce,Wladimiro Falcone,ITA,GK,30-042,1995,37.0,0,0,0,0,0,0,0,,0,0,0,0,0,0,29,3
ITA-Serie A,2425,Lecce,Ylber Ramadani,ALB,MF,29-042,1996,19.3,51,28,24,27,0,33,50,66.0,17,26,9,17,24,75,25,3
ITA-Serie A,2425,Lecce,Þórir Jóhann Helgason,ISL,MF,24-238,2000,12.5,10,7,3,6,1,7,13,53.8,6,7,2,5,5,15,10,2
ITA-Serie A,2425,Milan,Alejandro Jiménez,ESP,"DF,FW",20-016,2005,13.7,23,13,8,13,2,11,27,40.7,16,24,3,21,15,38,22,0
ITA-Serie A,2425,Milan,Alexis Saelemaekers,BEL,"DF,FW",25-331,1999,1.0,1,1,0,0,1,1,1,100.0,0,0,0,0,1,2,0,0
ITA-Serie A,2425,Milan,Bob Murphy Omoregbe,ITA,MF,21-200,2003,0.0,0,0,0,0,0,0,0,,0,0,0,0,0,0,0,0
ITA-Serie A,2425,Milan,Christian Pulisic,USA,"FW,MF",26-248,1998,26.6,42,28,16,14,12,15,37,40.5,22,24,2,22,5,47,13,2
ITA-Serie A,2425,Milan,Davide Bartesaghi,ITA,"DF,MF",19-146,2005,0.6,2,1,1,1,0,2,2,100.0,0,1,1,0,2,4,1,0
ITA-Serie A,2425,Milan,Davide Calabria,ITA,DF,28-169,1996,3.5,10,7,10,0,0,4,7,57.1,3,1,0,1,8,18,8,0
ITA-Serie A,2425,Milan,Emerson,BRA,DF,26-130,1999,15.3,45,28,24,16,5,16,34,47.1,18,13,2,11,14,59,56,0
ITA-Serie A,2425,Milan,Fikayo Tomori,ENG,DF,27-156,1997,16.7,37,23,19,16,2,15,23,65.2,8,16,12,4,19,56,58,2
ITA-Serie A,2425,Milan,Filippo Terracciano,ITA,"DF,MF",22-105,2003,6.0,9,6,1,6,2,5,10,50.0,5,1,0,1,6,15,11,0
ITA-Serie A,2425,Milan,Francesco Camarda,ITA,"FW,MF",17-075,2008,1.8,5,2,0,2,3,2,6,33.3,4,1,1,0,0,5,3,0
ITA-Serie A,2425,Milan,Ismaël Bennacer,ALG,MF,27-174,1997,3.3,5,4,1,3,1,1,7,14.3,6,5,3,2,3,8,1,0
ITA-Serie A,2425,Milan,João Félix,POR,MF,25-195,1999,7.6,6,6,3,2,1,4,14,28.6,10,2,0,2,1,7,9,0
ITA-Serie A,2425,Milan,Kevin Zeroli,ITA,MF,20-133,2005,0.1,1,1,0,1,0,0,0,,0,0,0,0,0,1,0,0
ITA-Serie A,2425,Milan,Kyle Walker,ENG,DF,34-361,1990,7.3,17,9,12,4,1,13,17,76.5,4,9,5,4,9,26,15,1
ITA-Serie A,2425,Milan,Luka Jović,SRB,"FW,MF",27-152,1997,5.7,0,0,0,0,0,0,0,,0,2,1,1,1,1,3,0
ITA-Serie A,2425,Milan,Malick Thiaw,GER,DF,23-289,2001,20.1,24,17,15,6,3,6,10,60.0,4,14,12,2,15,39,76,1
ITA-Serie A,2425,Milan,Marco Sportiello,ITA,GK,33-014,1992,1.4,0,0,0,0,0,0,0,,0,0,0,0,0,0,1,0
ITA-Serie A,2425,Milan,Matteo Gabbia,ITA,DF,25-215,1999,22.9,21,15,13,7,1,8,10,80.0,2,24,19,5,13,34,101,1
ITA-Serie A,2425,Milan,Mattia Liberali,ITA,MF,18-048,2007,0.7,2,1,0,1,1,2,2,100.0,0,0,0,0,0,2,0,0
ITA-Serie A,2425,Milan,Mike Maignan,FRA,GK,29-325,1995,35.6,0,0,0,0,0,0,1,0.0,1,1,0,1,0,0,19,3
ITA-Serie A,2425,Milan,Noah Okafor,SUI,FW,25-000,2000,4.6,2,1,0,0,2,0,1,0.0,1,1,0,1,2,4,1,0
ITA-Serie A,2425,Milan,Rafael Leão,POR,FW,25-348,1999,25.8,16,10,4,8,4,11,29,37.9,18,15,1,14,6,22,4,0
ITA-Serie A,2425,Milan,Riccardo Sottil,ITA,"FW,MF",25-355,1999,1.4,1,1,1,0,0,0,0,,0,0,0,0,0,1,0,0
ITA-Serie A,2425,Milan,Ruben Loftus-Cheek,ENG,MF,29-121,1996,10.5,16,7,4,8,4,5,11,45.5,6,3,0,3,3,19,18,0
ITA-Serie A,2425,Milan,Samuel Chukwueze,NGA,"FW,MF",26-002,1999,9.8,16,10,7,5,4,5,18,27.8,13,3,0,3,2,18,9,0
ITA-Serie A,2425,Milan,Santiago Giménez,MEX,FW,24-036,2001,7.4,5,3,0,4,1,3,4,75.0,1,3,1,2,1,6,13,0
ITA-Serie A,2425,Milan,Strahinja Pavlović,SRB,DF,24-000,2001,19.7,51,31,32,19,0,29,50,58.0,21,15,6,9,16,67,76,0
ITA-Serie A,2425,Milan,Tammy Abraham,ENG,FW,27-234,1997,13.1,17,11,2,10,5,6,8,75.0,2,13,0,13,2,19,16,0
ITA-Serie A,2425,Milan,Theo Hernández,FRA,DF,27-230,1997,30.0,36,28,23,10,3,21,39,53.8,18,25,10,15,17,53,75,3
ITA-Serie A,2425,Milan,Tijjani Reijnders,NED,MF,26-299,1998,33.8,25,13,6,14,5,10,26,38.5,16,22,4,18,35,60,27,2
ITA-Serie A,2425,Milan,Warren Bondo,FRA,MF,21-251,2003,1.8,5,3,4,1,0,3,3,100.0,0,1,0,1,0,5,2,0
ITA-Serie A,2425,Milan,Youssouf Fofana,FRA,MF,26-134,1999,27.7,56,34,20,31,5,26,52,50.0,26,32,9,23,19,75,23,3
ITA-Serie A,2425,Milan,Yunus Musah,USA,"MF,FW",22-176,2002,17.0,26,18,12,9,5,11,16,68.8,5,9,1,8,7,33,9,3
ITA-Serie A,2425,Milan,Álvaro Morata,ESP,"FW,MF",32-213,1992,12.2,16,10,5,8,3,5,8,62.5,3,7,2,5,5,21,5,0
ITA-Serie A,2425,Monza,Alessandro Bianco,ITA,MF,22-235,2002,27.9,50,28,25,17,8,27,40,67.5,13,39,14,25,22,72,53,4
ITA-Serie A,2425,Monza,Andrea Carboni,ITA,DF,24-109,2001,23.3,57,32,37,16,4,32,50,64.0,18,30,16,14,27,84,104,4
ITA-Serie A,2425,Monza,Andrea Petagna,ITA,FW,29-328,1995,3.6,2,1,0,1,1,1,2,50.0,1,0,0,0,1,3,2,0
ITA-Serie A,2425,Monza,Armando Izzo,ITA,DF,33-083,1992,26.9,40,15,30,9,1,18,36,50.0,18,38,28,10,45,85,100,0
ITA-Serie A,2425,Monza,Arvid Brorsson,SWE,DF,26-016,1999,4.0,4,3,2,2,0,2,5,40.0,3,9,8,1,2,6,35,1
ITA-Serie A,2425,Monza,Daniel Maldini,ITA,"MF,FW",23-225,2001,14.5,14,6,5,9,0,6,13,46.2,7,8,2,6,4,18,12,2
ITA-Serie A,2425,Monza,Danilo D'Ambrosio,ITA,DF,36-257,1988,12.2,28,15,17,10,1,14,23,60.9,9,12,8,4,15,43,36,2
ITA-Serie A,2425,Monza,Dany Mota,POR,"FW,MF",27-022,1998,23.4,13,3,2,3,8,4,8,50.0,4,18,1,17,9,22,27,3
ITA-Serie A,2425,Monza,Gaetano Castrovilli,ITA,MF,28-096,1997,6.4,12,7,10,2,0,4,11,36.4,7,8,2,6,2,14,9,0
ITA-Serie A,2425,Monza,Gianluca Caprari,ITA,"MF,FW",31-298,1993,17.6,19,11,8,8,3,7,14,50.0,7,14,0,14,7,26,2,1
ITA-Serie A,2425,Monza,Giorgos Kyriakopoulos,GRE,DF,29-108,1996,30.6,42,26,19,18,5,29,59,49.2,30,28,10,18,23,65,77,0
ITA-Serie A,2425,Monza,Jean-Daniel Akpa-Akpro,CIV,"MF,DF",32-225,1992,9.7,28,18,13,14,1,9,18,50.0,9,19,6,13,11,39,13,1
ITA-Serie A,2425,Monza,Kacper Urbanski,POL,MF,20-259,2004,5.6,5,3,1,2,2,4,7,57.1,3,7,2,5,2,7,9,0
ITA-Serie A,2425,Monza,Keita Baldé,SEN,FW,30-077,1995,6.2,1,1,0,1,0,1,2,50.0,1,4,0,4,2,3,0,0
ITA-Serie A,2425,Monza,Kevin Martins,ITA,"MF,DF",20-113,2005,2.0,5,4,3,2,0,3,6,50.0,3,1,0,1,1,6,4,1
ITA-Serie A,2425,Monza,Kevin Zeroli,ITA,MF,20-133,2005,4.4,6,2,3,3,0,0,1,0.0,1,6,1,5,2,8,11,0
ITA-Serie A,2425,Monza,Luca Caldirola,ITA,DF,34-112,1991,8.9,11,7,8,3,0,4,7,57.1,3,8,6,2,11,22,40,0
ITA-Serie A,2425,Monza,Matteo Pessina,ITA,MF,28-033,1997,9.5,15,4,3,11,1,9,14,64.3,5,6,0,6,12,27,7,0
ITA-Serie A,2425,Monza,Mattia Valoti,ITA,MF,31-260,1993,0.4,3,3,3,0,0,0,2,0.0,2,2,0,2,0,3,2,0
ITA-Serie A,2425,Monza,Milan Đurić,BIH,FW,35-002,1990,14.1,1,1,0,1,0,0,3,0.0,3,6,0,6,2,3,17,0
ITA-Serie A,2425,Monza,Mirko Marić,CRO,"FW,MF",30-008,1995,1.2,1,0,1,0,0,1,2,50.0,1,1,1,0,1,2,1,0
ITA-Serie A,2425,Monza,Omari Forson,ENG,"MF,FW",20-308,2004,2.5,3,3,1,2,0,1,3,33.3,2,3,0,3,1,4,1,0
ITA-Serie A,2425,Monza,Pablo Marí,ESP,DF,31-266,1993,18.1,26,15,14,12,0,11,21,52.4,10,24,21,3,37,63,85,2
ITA-Serie A,2425,Monza,Patrick Ciurria,ITA,"MF,DF",30-104,1995,11.6,22,14,11,7,4,4,11,36.4,7,13,3,10,6,28,19,0
ITA-Serie A,2425,Monza,Pedro Pereira,POR,DF,27-122,1998,28.6,53,32,30,18,5,35,55,63.6,20,25,11,14,18,71,83,4
ITA-Serie A,2425,Monza,Roberto Gagliardini,ITA,"MF,DF",31-047,1994,2.0,3,2,1,2,0,1,4,25.0,3,1,0,1,2,5,4,0
ITA-Serie A,2425,Monza,Samuele Birindelli,ITA,DF,25-309,1999,15.3,19,14,10,4,5,6,13,46.2,7,14,2,12,9,28,32,2
ITA-Serie A,2425,Monza,Samuele Vignato,ITA,MF,21-089,2004,5.2,6,3,0,4,2,3,7,42.9,4,1,0,1,0,6,6,0
ITA-Serie A,2425,Monza,Semuel Pizzignacco,ITA,GK,23-265,2001,7.3,0,0,0,0,0,0,1,0.0,1,0,0,0,0,0,6,0
ITA-Serie A,2425,Monza,Silvère Ganvoula M'Boussy,CGO,FW,28-336,1996,3.6,0,0,0,0,0,0,1,0.0,1,1,0,1,1,1,5,0
ITA-Serie A,2425,Monza,Stefan Lekovic,SRB,DF,21-135,2004,4.1,9,4,6,2,1,5,13,38.5,8,4,4,0,7,16,5,0
ITA-Serie A,2425,Monza,Stefano Sensi,ITA,MF,29-292,1995,2.8,8,5,4,4,0,5,6,83.3,1,3,2,1,3,11,3,1
ITA-Serie A,2425,Monza,Stefano Turati,ITA,GK,23-261,2001,29.7,0,0,0,0,0,0,1,0.0,1,0,0,0,0,0,21,2
ITA-Serie A,2425,Monza,Tomás Palacios,ARG,DF,22-026,2003,5.0,11,5,9,2,0,9,13,69.2,4,7,2,5,8,19,17,2
ITA-Serie A,2425,Monza,Warren Bondo,FRA,MF,21-251,2003,18.0,35,24,19,12,4,13,19,68.4,6,16,6,10,5,40,8,4
ITA-Serie A,2425,Napoli,Alessandro Buongiorno,ITA,DF,25-352,1999,21.4,39,23,26,12,1,24,32,75.0,8,30,18,12,35,74,73,2
ITA-Serie A,2425,Napoli,Alessio Zerbin,ITA,"FW,DF",26-082,1999,0.0,2,1,2,0,0,1,1,100.0,0,0,0,0,0,2,0,0
ITA-Serie A,2425,Napoli,Alex Meret,ITA,GK,28-063,1997,33.4,0,0,0,0,0,0,0,,0,1,0,1,0,0,16,0
ITA-Serie A,2425,Napoli,Amir Rrahmani,KVX,DF,31-089,1994,37.8,39,31,19,19,1,16,25,64.0,9,43,26,17,27,66,179,2
ITA-Serie A,2425,Napoli,Andre-Frank Zambo Anguissa,CMR,MF,29-189,1995,31.7,42,26,8,28,6,15,34,44.1,19,24,6,18,35,77,40,1
ITA-Serie A,2425,Napoli,Billy Gilmour,SCO,MF,23-347,2001,13.1,24,15,10,9,5,12,20,60.0,8,6,1,5,9,33,23,0
ITA-Serie A,2425,Napoli,Cyril Ngonge,BEL,FW,24-363,2000,2.4,8,5,4,4,0,4,7,57.1,3,3,0,3,2,10,4,0
ITA-Serie A,2425,Napoli,David Neres,BRA,FW,28-082,1997,14.3,20,11,9,4,7,10,15,66.7,5,7,0,7,7,27,4,0
ITA-Serie A,2425,Napoli,Elia Caprile,ITA,GK,23-272,2001,3.6,0,0,0,0,0,0,0,,0,0,0,0,0,0,2,0
ITA-Serie A,2425,Napoli,Giacomo Raspadori,ITA,"FW,MF",25-095,2000,12.3,18,9,6,10,2,8,12,66.7,4,10,2,8,3,21,13,0
ITA-Serie A,2425,Napoli,Giovanni Di Lorenzo,ITA,DF,31-293,1993,37.0,66,44,35,25,6,42,65,64.6,23,19,6,13,31,97,85,1
ITA-Serie A,2425,Napoli,Giovanni Simeone,ARG,FW,29-323,1995,4.7,2,0,0,1,1,1,6,16.7,5,9,2,7,1,3,6,0
ITA-Serie A,2425,Napoli,Juan Jesus,BRA,DF,33-348,1991,11.9,25,14,16,9,0,12,20,60.0,8,15,3,12,9,34,42,0
ITA-Serie A,2425,Napoli,Khvicha Kvaratskhelia,GEO,"FW,MF",24-101,2001,13.1,15,9,4,10,1,4,15,26.7,11,13,0,13,4,19,7,0
ITA-Serie A,2425,Napoli,Leonardo Spinazzola,ITA,"DF,FW",32-060,1993,16.9,17,10,6,9,2,10,23,43.5,13,12,1,11,9,26,31,1
ITA-Serie A,2425,Napoli,Mathías Olivera,URU,DF,27-205,1997,26.3,63,35,31,25,7,32,53,60.4,21,36,12,24,28,91,74,1
ITA-Serie A,2425,Napoli,Matteo Politano,ITA,"FW,MF",31-294,1993,31.2,29,15,17,11,1,15,43,34.9,28,21,1,20,13,42,50,1
ITA-Serie A,2425,Napoli,Michael Folorunsho,ITA,"FW,MF",27-106,1998,0.4,3,2,0,3,0,2,4,50.0,2,0,0,0,1,4,1,1
ITA-Serie A,2425,Napoli,Noah Okafor,SUI,"FW,MF",25-000,2000,0.4,3,2,3,0,0,2,2,100.0,0,0,0,0,0,3,1,0
ITA-Serie A,2425,Napoli,Pasquale Mazzocchi,ITA,"DF,FW",29-301,1995,7.8,15,7,7,5,3,8,15,53.3,7,5,2,3,5,20,25,0
ITA-Serie A,2425,Napoli,Philip Billing,DEN,MF,28-347,1996,2.2,9,6,4,4,1,1,4,25.0,3,4,1,3,4,13,6,0
ITA-Serie A,2425,Napoli,Rafa Marín,ESP,DF,23-005,2002,1.6,1,0,1,0,0,1,2,50.0,1,1,1,0,1,2,4,0
ITA-Serie A,2425,Napoli,Romelu Lukaku,BEL,FW,32-011,1993,31.6,4,2,0,2,2,1,4,25.0,3,7,2,5,1,5,17,0
ITA-Serie A,2425,Napoli,Scott McTominay,SCO,MF,28-167,1996,32.6,43,25,12,27,4,18,36,50.0,18,22,5,17,24,67,51,0
ITA-Serie A,2425,Napoli,Simone Scuffet,ITA,GK,28-358,1996,1.0,0,0,0,0,0,0,0,,0,0,0,0,0,0,2,0
ITA-Serie A,2425,Napoli,Stanislav Lobotka,SVK,MF,30-180,1994,29.3,47,30,16,21,10,19,31,61.3,12,29,11,18,21,68,57,1
ITA-Serie A,2425,Napoli,Walid Cheddira,MAR,FW,27-122,1998,0.1,0,0,0,0,0,0,0,,0,0,0,0,0,0,0,0
ITA-Serie A,2425,Parma,Adrian Benedyczak,POL,"FW,MF",24-181,2000,2.4,0,0,0,0,0,0,1,0.0,1,3,1,2,0,0,8,0
ITA-Serie A,2425,Parma,Adrian Bernabe,ESP,MF,23-363,2001,15.2,28,18,16,8,4,14,31,45.2,17,22,9,13,7,35,25,1
ITA-Serie A,2425,Parma,Alessandro Circati,AUS,DF,21-226,2003,5.0,5,3,4,1,0,1,1,100.0,0,5,4,1,2,7,36,1
ITA-Serie A,2425,Parma,Alessandro Vogliacco,ITA,DF,26-252,1998,8.6,5,2,5,0,0,3,5,60.0,2,15,10,5,3,8,37,0
ITA-Serie A,2425,Parma,Ange-Yoan Bonny,FRA,FW,21-211,2003,27.1,34,16,4,23,7,8,14,57.1,6,17,2,15,3,37,17,0
ITA-Serie A,2425,Parma,Antoine Hainaut,FRA,"DF,MF",23-095,2002,12.9,26,14,15,8,3,9,13,69.2,4,17,4,13,15,41,59,0
ITA-Serie A,2425,Parma,Botond Balogh,HUN,DF,22-352,2002,21.8,32,13,20,12,0,17,23,73.9,6,32,24,8,25,57,137,2
ITA-Serie A,2425,Parma,Dennis Man,ROU,"FW,MF",26-271,1998,22.2,13,6,7,3,3,6,24,25.0,18,15,3,12,8,21,11,0
ITA-Serie A,2425,Parma,Drissa Camara,CIV,"MF,FW",23-095,2002,5.0,9,7,2,6,1,1,10,10.0,9,8,0,8,3,12,1,0
ITA-Serie A,2425,Parma,Emanuele Valeri,ITA,DF,26-168,1998,31.4,51,31,33,15,3,30,60,50.0,30,31,10,21,28,79,101,4
ITA-Serie A,2425,Parma,Enrico Del Prato,ITA,DF,25-195,1999,31.7,32,17,23,8,1,19,26,73.1,7,68,34,34,19,51,128,2
ITA-Serie A,2425,Parma,Gabriel Charpentier,CGO,FW,26-007,1999,3.0,4,3,2,1,1,3,4,75.0,1,3,0,3,0,4,9,0
ITA-Serie A,2425,Parma,Giovanni Leoni,ITA,DF,18-154,2006,13.3,14,6,10,4,0,5,10,50.0,5,20,11,9,15,29,63,1
ITA-Serie A,2425,Parma,Hernani,BRA,MF,31-058,1994,14.2,45,24,24,17,4,25,47,53.2,22,26,6,20,19,64,11,1
ITA-Serie A,2425,Parma,Jacob Ondrejka,SWE,"MF,FW",22-264,2002,4.2,12,6,5,7,0,10,12,83.3,2,2,0,2,7,19,2,0
ITA-Serie A,2425,Parma,Lautaro Valenti,ARG,DF,26-130,1999,16.3,16,12,12,3,1,6,6,100.0,0,24,12,12,11,27,93,1
ITA-Serie A,2425,Parma,Leandro Chichizola,ARG,GK,35-058,1990,1.0,0,0,0,0,0,0,0,,0,0,0,0,0,0,2,0
ITA-Serie A,2425,Parma,Mandela Keita,BEL,MF,23-014,2002,20.2,44,25,13,25,6,18,35,51.4,17,18,7,11,21,65,29,2
ITA-Serie A,2425,Parma,Mateo Pellegrino,ARG,FW,24-084,2001,7.2,3,2,1,2,0,1,3,33.3,2,5,1,4,0,3,6,0
ITA-Serie A,2425,Parma,Mateusz Kowalski,POL,MF,19-307,2005,0.6,0,0,0,0,0,0,0,,0,1,0,1,0,0,1,0
ITA-Serie A,2425,Parma,Mathias Løvik,NOR,"DF,FW",21-169,2003,1.0,1,0,0,1,0,1,3,33.3,2,1,1,0,2,3,3,0
ITA-Serie A,2425,Parma,Matteo Cancellieri,ITA,"FW,MF",23-101,2002,15.8,26,16,15,9,2,11,32,34.4,21,15,1,14,13,39,30,0
ITA-Serie A,2425,Parma,Milan Đurić,BIH,FW,35-002,1990,3.0,0,0,0,0,0,0,2,0.0,2,3,0,3,0,0,2,0
ITA-Serie A,2425,Parma,Mohamed Haj,TUN,MF,20-059,2005,5.0,3,1,2,1,0,1,2,50.0,1,3,1,2,4,7,5,0
ITA-Serie A,2425,Parma,Nahuel Estévez,ARG,MF,29-191,1995,7.2,14,5,6,7,1,5,14,35.7,9,9,2,7,3,17,25,0
ITA-Serie A,2425,Parma,Pontus Almqvist,SWE,"FW,MF",25-318,1999,12.4,17,13,7,7,3,8,17,47.1,9,13,0,13,19,36,8,0
ITA-Serie A,2425,Parma,Simon Sohm,SUI,MF,24-043,2001,32.4,28,17,11,13,4,16,35,45.7,19,10,3,7,25,53,36,0
ITA-Serie A,2425,Parma,Valentin Mihaila,ROU,"FW,MF",25-111,2000,14.3,29,15,8,13,8,9,22,40.9,13,18,0,18,8,37,6,0
ITA-Serie A,2425,Parma,Woyo Coulibaly,FRA,DF,26-004,1999,12.0,13,10,9,2,2,5,11,45.5,6,19,2,17,8,21,25,0
ITA-Serie A,2425,Parma,Wylan Cyprien,FRA,MF,30-116,1995,0.3,0,0,0,0,0,0,1,0.0,1,1,0,1,1,1,0,0
ITA-Serie A,2425,Parma,Yordan Osorio,VEN,DF,31-014,1994,1.9,5,3,4,1,0,2,2,100.0,0,3,1,2,4,9,6,1
ITA-Serie A,2425,Parma,Zion Suzuki,JPN,GK,22-276,2002,35.8,1,0,1,0,0,1,2,50.0,1,0,0,0,0,1,33,4
ITA-Serie A,2425,Roma,Alexis Saelemaekers,BEL,"DF,FW",25-331,1999,14.4,30,17,21,6,3,16,31,51.6,15,12,1,11,8,38,8,1
ITA-Serie A,2425,Roma,Anass Salah-Eddine,NED,DF,23-126,2002,1.7,1,1,1,0,0,0,0,,0,0,0,0,1,2,2,2
ITA-Serie A,2425,Roma,Angeliño,ESP,DF,28-140,1997,34.3,46,24,20,24,2,17,34,50.0,17,33,9,24,27,73,96,0
ITA-Serie A,2425,Roma,Artem Dovbyk,UKR,FW,27-337,1997,26.9,4,2,0,1,3,0,4,0.0,4,10,3,7,2,6,12,0
ITA-Serie A,2425,Roma,Bryan Cristante,ITA,MF,30-082,1995,21.7,47,28,17,24,6,15,26,57.7,11,19,10,9,19,66,35,1
ITA-Serie A,2425,Roma,Devyne Rensch,NED,DF,22-126,2003,5.2,17,13,8,8,1,9,10,90.0,1,5,3,2,7,24,12,1
ITA-Serie A,2425,Roma,Eldor Shomurodov,UZB,"FW,MF",29-329,1995,11.4,13,5,2,7,4,3,6,50.0,3,9,1,8,3,16,5,0
ITA-Serie A,2425,Roma,Enzo Le Fée,FRA,MF,25-110,2000,3.5,7,4,5,2,0,2,6,33.3,4,9,3,6,5,12,2,0
ITA-Serie A,2425,Roma,Gianluca Mancini,ITA,DF,29-037,1996,33.9,42,26,22,18,2,20,34,58.8,14,22,16,6,35,77,98,0
ITA-Serie A,2425,Roma,Leandro Paredes,ARG,MF,30-329,1994,14.3,26,14,9,12,5,16,32,50.0,16,13,4,9,19,45,31,1
ITA-Serie A,2425,Roma,Lorenzo Pellegrini,ITA,MF,28-339,1996,18.1,24,16,5,13,6,8,19,42.1,11,8,1,7,6,30,22,0
ITA-Serie A,2425,Roma,Lucas Gourna-Douath,FRA,MF,21-292,2003,2.5,9,4,5,4,0,2,6,33.3,4,1,1,0,0,9,2,0
ITA-Serie A,2425,Roma,Manu Koné,FRA,MF,24-007,2001,27.6,40,25,17,17,6,19,40,47.5,21,26,4,22,24,64,27,0
ITA-Serie A,2425,Roma,Mario Hermoso,ESP,DF,29-340,1995,2.8,2,1,2,0,0,0,1,0.0,1,1,1,0,4,6,13,0
ITA-Serie A,2425,Roma,Mats Hummels,GER,DF,36-159,1988,10.2,30,15,16,14,0,11,18,61.1,7,12,4,8,26,56,43,0
ITA-Serie A,2425,Roma,Matìas Soulé,ARG,"MF,DF",22-039,2003,18.8,25,16,11,7,7,10,23,43.5,13,25,3,22,9,34,25,0
ITA-Serie A,2425,Roma,Mile Svilar,SRB,GK,25-270,1999,37.0,0,0,0,0,0,0,0,,0,0,0,0,0,0,12,2
ITA-Serie A,2425,Roma,Niccolò Pisilli,ITA,MF,20-243,2004,13.6,23,10,10,8,5,12,22,54.5,10,14,3,11,11,34,16,0
ITA-Serie A,2425,Roma,Nicola Zalewski,POL,"DF,FW",23-121,2002,5.9,8,6,3,2,3,2,7,28.6,5,7,2,5,4,12,8,2
ITA-Serie A,2425,Roma,Obite N'Dicka,CIV,DF,25-277,1999,37.0,32,26,17,15,0,14,21,66.7,7,44,28,16,33,65,144,1
ITA-Serie A,2425,Roma,Paulo Dybala,ARG,"FW,MF",31-190,1993,15.7,17,7,3,9,5,8,19,42.1,11,12,1,11,2,19,2,0
ITA-Serie A,2425,Roma,Samuel Dahl,SWE,"DF,MF",25-081,2000,0.5,2,2,0,2,0,1,2,50.0,1,2,0,2,0,2,0,0
ITA-Serie A,2425,Roma,Saud Abdulhamid,KSA,DF,25-310,1999,2.3,3,2,2,0,1,1,1,100.0,0,2,0,2,2,5,0,0
ITA-Serie A,2425,Roma,Stephan El Shaarawy,ITA,"DF,MF",32-209,1992,12.0,16,12,4,6,6,6,12,50.0,6,4,0,4,10,26,13,0
ITA-Serie A,2425,Roma,Tammy Abraham,ENG,FW,27-234,1997,0.0,0,0,0,0,0,0,1,0.0,1,0,0,0,0,0,0,0
ITA-Serie A,2425,Roma,Tommaso Baldanzi,ITA,"MF,FW",22-062,2003,9.2,12,4,5,4,3,4,12,33.3,8,4,0,4,6,18,8,0
ITA-Serie A,2425,Roma,Victor Nelsson,DEN,DF,26-222,1998,2.1,5,4,3,1,1,3,5,60.0,2,1,0,1,2,7,9,0
ITA-Serie A,2425,Roma,Zeki Çelik,TUR,DF,28-096,1997,24.1,61,36,20,31,10,23,42,54.8,19,26,8,18,15,76,84,3
ITA-Serie A,2425,Torino,Aaron Ciammaglichella,ITA,MF,20-118,2005,0.0,0,0,0,0,0,0,0,,0,0,0,0,0,0,0,0
ITA-Serie A,2425,Torino,Adam Masina,MAR,DF,31-142,1994,20.5,33,15,22,10,1,23,40,57.5,17,27,15,12,26,59,92,2
ITA-Serie A,2425,Torino,Adrien Tameze,CMR,"MF,DF",31-109,1994,7.2,5,2,2,3,0,1,10,10.0,9,8,5,3,10,15,8,1
ITA-Serie A,2425,Torino,Alberto Paleari,ITA,GK,32-268,1992,1.0,0,0,0,0,0,0,0,,0,0,0,0,0,0,2,0
ITA-Serie A,2425,Torino,Alessio Cacciamani,ITA,"MF,DF",17-329,2007,0.3,0,0,0,0,0,0,0,,0,0,0,0,1,1,0,0
ITA-Serie A,2425,Torino,Ali Dembélé,FRA,DF,21-139,2004,3.7,9,5,6,3,0,4,4,100.0,0,5,1,4,1,10,11,1
ITA-Serie A,2425,Torino,Antonio Sanabria,PAR,FW,29-081,1996,14.6,3,3,1,1,1,1,4,25.0,3,6,1,5,1,4,13,0
ITA-Serie A,2425,Torino,Borna Sosa,CRO,DF,27-123,1998,13.1,26,19,14,7,5,16,25,64.0,9,13,6,7,14,40,33,0
ITA-Serie A,2425,Torino,Cesare Casadei,ITA,MF,22-134,2003,10.7,12,5,4,8,0,5,10,50.0,5,3,2,1,5,17,25,0
ITA-Serie A,2425,Torino,Che Adams,SCO,FW,28-315,1996,28.5,10,5,1,4,5,0,5,0.0,5,13,6,7,2,12,18,0
ITA-Serie A,2425,Torino,Cristiano Biraghi,ITA,DF,32-265,1992,11.9,14,10,8,2,4,9,16,56.3,7,15,4,11,8,22,43,0
ITA-Serie A,2425,Torino,Duván Zapata,COL,FW,34-053,1991,6.5,7,5,2,0,5,0,3,0.0,3,2,1,1,2,9,7,0
ITA-Serie A,2425,Torino,Elif Elmas,MKD,"FW,MF",25-242,1999,10.5,8,5,3,5,0,4,9,44.4,5,7,2,5,6,14,5,2
ITA-Serie A,2425,Torino,Eybi Nije,SWE,"FW,MF",20-010,2005,4.4,5,1,3,1,1,0,3,0.0,3,5,1,4,0,5,1,0
ITA-Serie A,2425,Torino,Guillermo Maripán,CHI,DF,31-018,1994,25.0,37,22,23,13,1,20,32,62.5,12,26,12,14,40,77,134,1
ITA-Serie A,2425,Torino,Gvidas Gineitis,LTU,MF,21-039,2004,15.5,25,15,8,10,7,13,25,52.0,12,16,6,10,18,43,32,0
ITA-Serie A,2425,Torino,Ivan Ilić,SRB,MF,24-068,2001,10.2,5,2,0,4,1,2,8,25.0,6,0,0,0,5,10,10,0
ITA-Serie A,2425,Torino,Karol Linetty,POL,MF,30-111,1995,16.9,39,23,17,19,3,20,41,48.8,21,14,5,9,12,51,31,1
ITA-Serie A,2425,Torino,Marcus Pedersen,NOR,DF,24-312,2000,15.1,13,8,6,6,1,10,16,62.5,6,11,2,9,13,26,34,1
ITA-Serie A,2425,Torino,Mërgim Vojvoda,KVX,DF,30-112,1995,12.3,18,10,5,9,4,7,14,50.0,7,13,3,10,7,25,24,1
ITA-Serie A,2425,Torino,Nikola Vlašić,CRO,"MF,FW",27-232,1997,22.5,35,18,10,16,9,12,30,40.0,18,14,3,11,9,44,15,0
ITA-Serie A,2425,Torino,Raoul Bellanova,ITA,DF,25-007,2000,1.0,0,0,0,0,0,0,1,0.0,1,0,0,0,0,0,4,0
ITA-Serie A,2425,Torino,Saba Sazonov,GEO,DF,23-112,2002,0.0,0,0,0,0,0,0,0,,0,1,1,0,0,0,0,0
ITA-Serie A,2425,Torino,Samuele Ricci,ITA,MF,23-276,2001,30.6,33,19,15,13,5,18,27,66.7,9,21,9,12,25,58,51,2
ITA-Serie A,2425,Torino,Saúl Coco,EQG,DF,26-104,1999,31.6,46,26,31,14,1,19,30,63.3,11,49,31,18,38,84,157,4
ITA-Serie A,2425,Torino,Sebastian Walukiewicz,POL,DF,25-049,2000,18.2,38,20,18,16,4,23,31,74.2,8,21,8,13,18,56,58,0
ITA-Serie A,2425,Torino,Sergiu Perciun,MDA,"FW,MF",19-031,2006,1.3,1,1,0,0,1,0,2,0.0,2,2,0,2,1,2,2,0
ITA-Serie A,2425,Torino,Valentino Lazaro,AUT,"DF,FW",29-061,1996,24.6,26,12,10,12,4,15,28,53.6,13,28,5,23,11,37,38,1
ITA-Serie A,2425,Torino,Vanja Milinković-Savić,SRB,GK,28-093,1997,36.0,1,0,1,0,0,1,3,33.3,2,0,0,0,0,1,17,4
ITA-Serie A,2425,Torino,Yann Karamoh,FRA,"MF,FW",26-320,1998,11.6,5,2,2,1,2,4,9,44.4,5,10,2,8,3,8,5,0
ITA-Serie A,2425,Udinese,Alexis Sánchez,CHI,FW,36-156,1988,4.3,3,1,0,2,1,1,5,20.0,4,4,0,4,3,6,0,1
ITA-Serie A,2425,Udinese,Arthur Atta,FRA,"MF,FW",22-130,2003,13.1,20,12,9,10,1,10,15,66.7,5,7,4,3,7,27,15,1
ITA-Serie A,2425,Udinese,Brenner,BRA,"MF,FW",25-128,2000,4.3,6,4,2,3,1,3,8,37.5,5,4,0,4,1,7,6,0
ITA-Serie A,2425,Udinese,Christian Kabasele,BEL,DF,34-089,1991,11.9,16,9,9,7,0,10,12,83.3,2,11,5,6,12,28,62,1
ITA-Serie A,2425,Udinese,Damián Pizarro,CHI,"FW,MF",20-057,2005,0.2,0,0,0,0,0,0,0,,0,0,0,0,0,0,0,0
ITA-Serie A,2425,Udinese,Daniele Padelli,ITA,GK,39-211,1985,1.0,0,0,0,0,0,0,1,0.0,1,0,0,0,0,0,0,0
ITA-Serie A,2425,Udinese,Enzo Ebosse,CMR,DF,26-074,1999,1.0,0,0,0,0,0,0,2,0.0,2,3,3,0,1,1,1,0
ITA-Serie A,2425,Udinese,Florian Thauvin,FRA,"FW,MF",32-118,1993,21.7,20,14,9,8,3,10,25,40.0,15,6,0,6,7,27,10,0
ITA-Serie A,2425,Udinese,Hassane Kamara,CIV,DF,31-080,1994,22.2,35,25,20,11,4,16,28,57.1,12,23,5,18,26,61,49,1
ITA-Serie A,2425,Udinese,Iker Bravo,ESP,"FW,MF",20-131,2005,7.4,9,5,2,5,2,4,8,50.0,4,3,0,3,1,10,4,0
ITA-Serie A,2425,Udinese,Jaka Bijol,SVN,DF,26-108,1999,32.5,43,25,32,10,1,21,39,53.8,18,37,18,19,38,81,179,1
ITA-Serie A,2425,Udinese,James Abankwah,IRL,"DF,MF",21-128,2004,1.0,4,2,4,0,0,2,3,66.7,1,2,1,1,1,5,3,0
ITA-Serie A,2425,Udinese,Jesper Karlström,SWE,MF,29-337,1995,34.4,60,33,31,21,8,25,50,50.0,25,28,11,17,34,94,79,4
ITA-Serie A,2425,Udinese,Jordan Zemura,ZIM,DF,25-191,1999,14.7,28,13,13,10,5,15,26,57.7,11,16,3,13,15,43,40,0
ITA-Serie A,2425,Udinese,Jurgen Ekkelenkamp,NED,MF,25-049,2000,20.0,35,24,10,21,4,17,33,51.5,16,25,4,21,12,47,25,0
ITA-Serie A,2425,Udinese,Keinan Davis,ENG,FW,27-100,1998,11.7,9,4,1,4,4,3,6,50.0,3,2,1,1,1,10,5,0
ITA-Serie A,2425,Udinese,Kingsley Ehizibue,NED,DF,29-364,1995,26.8,54,35,31,18,5,25,41,61.0,16,38,11,27,23,77,66,5
ITA-Serie A,2425,Udinese,Lautaro Gianetti,ARG,DF,31-192,1993,9.8,22,10,16,5,1,14,20,70.0,6,20,10,10,15,37,49,1
ITA-Serie A,2425,Udinese,Lorenzo Lucca,ITA,FW,24-256,2000,25.3,9,6,2,2,5,4,10,40.0,6,18,1,17,6,15,24,0
ITA-Serie A,2425,Udinese,Maduka Okoye,NGA,GK,25-269,1999,24.0,0,0,0,0,0,0,0,,0,0,0,0,0,0,12,1
ITA-Serie A,2425,Udinese,Martín Payero,ARG,MF,26-255,1998,15.3,24,16,4,14,6,8,16,50.0,8,16,2,14,13,37,13,0
ITA-Serie A,2425,Udinese,Nehuén Pérez,ARG,DF,24-334,2000,2.0,1,1,0,0,1,0,1,0.0,1,2,2,0,1,2,7,0
ITA-Serie A,2425,Udinese,Oier Zarraga,ESP,MF,26-140,1999,9.5,17,11,7,9,1,9,20,45.0,11,8,5,3,2,19,8,0
ITA-Serie A,2425,Udinese,Oumar Solet,FRA,DF,25-106,2000,17.6,33,19,18,13,2,21,30,70.0,9,31,18,13,17,50,70,4
ITA-Serie A,2425,Udinese,Razvan Sava,ROU,GK,22-337,2002,12.0,0,0,0,0,0,0,0,,0,0,0,0,0,0,6,2
ITA-Serie A,2425,Udinese,Rui Modesto,ANG,"DF,MF",25-229,1999,6.8,16,12,4,9,3,7,9,77.8,2,10,0,10,8,24,13,0
ITA-Serie A,2425,Udinese,Sandi Lovrić,SVN,MF,27-057,1998,25.6,46,29,25,17,4,22,44,50.0,22,33,5,28,22,68,27,1
ITA-Serie A,2425,Udinese,Simone Pafundi,ITA,"MF,DF",19-099,2006,1.3,3,3,2,0,1,1,4,25.0,3,0,0,0,0,3,1,0
ITA-Serie A,2425,Udinese,Souleymane Touré,FRA,DF,22-057,2003,8.1,7,6,4,3,0,4,5,80.0,1,15,6,9,9,16,17,1
ITA-Serie A,2425,Udinese,Thomas Kristensen,DEN,DF,23-127,2002,19.5,31,21,16,11,4,20,32,62.5,12,18,13,5,21,52,80,2
ITA-Serie A,2425,Venezia,Alessandro Marcandalli,ITA,DF,22-241,2002,3.8,7,5,5,2,0,2,5,40.0,3,6,3,3,2,9,26,0
ITA-Serie A,2425,Venezia,Alessio Zerbin,ITA,DF,26-082,1999,15.9,49,28,28,12,9,27,49,55.1,22,27,3,24,15,64,25,1
ITA-Serie A,2425,Venezia,Alfred Duncan,GHA,MF,32-075,1993,10.6,17,8,4,11,2,5,14,35.7,9,7,2,5,8,25,8,0
ITA-Serie A,2425,Venezia,Antonio Candela,ITA,DF,25-027,2000,11.2,31,21,13,11,7,18,26,69.2,8,7,5,2,8,39,22,2
ITA-Serie A,2425,Venezia,Antonio Raimondo,ITA,"FW,DF",21-067,2004,1.0,2,1,1,1,0,0,0,,0,0,0,0,0,2,0,1
ITA-Serie A,2425,Venezia,Bjarki Bjarkason,ISL,"DF,MF",25-013,2000,1.8,3,2,2,1,0,1,2,50.0,1,1,0,1,2,5,4,0
ITA-Serie A,2425,Venezia,Cheick Oumar Conde,GUI,MF,24-302,2000,1.7,6,5,3,2,1,2,5,40.0,3,7,2,5,4,10,3,0
ITA-Serie A,2425,Venezia,Christian Gytkjær,DEN,FW,35-018,1990,8.1,6,4,2,2,2,1,2,50.0,1,3,1,2,0,6,8,0
ITA-Serie A,2425,Venezia,Daniel Fila,CZE,FW,22-276,2002,4.7,2,0,0,1,1,0,2,0.0,2,5,0,5,0,2,5,0
ITA-Serie A,2425,Venezia,Domen Črnigoj,SVN,MF,29-187,1995,1.5,4,2,0,1,3,1,2,50.0,1,5,2,3,4,8,4,0
ITA-Serie A,2425,Venezia,Fali Candé,GNB,DF,27-120,1998,16.0,25,19,14,10,1,16,23,69.6,7,20,14,6,14,39,83,2
ITA-Serie A,2425,Venezia,Filip Stankovic,SRB,GK,23-088,2002,15.2,0,0,0,0,0,0,0,,0,0,0,0,0,0,11,2
ITA-Serie A,2425,Venezia,Francesco Zampano,ITA,DF,31-236,1993,18.2,31,20,19,10,2,14,31,45.2,17,21,1,20,6,37,29,2
ITA-Serie A,2425,Venezia,Franco Carboni,ITA,DF,22-050,2003,2.5,5,3,5,0,0,5,8,62.5,3,1,1,0,0,5,11,0
ITA-Serie A,2425,Venezia,Gaetano Oristanio,ITA,"FW,MF",22-238,2002,25.6,17,13,5,8,4,7,15,46.7,8,16,0,16,6,23,6,1
ITA-Serie A,2425,Venezia,Gianluca Busio,USA,MF,22-361,2002,28.0,46,31,24,12,10,20,47,42.6,27,36,8,28,19,65,52,0
ITA-Serie A,2425,Venezia,Giorgio Altare,ITA,DF,26-288,1998,8.4,13,12,8,3,2,8,15,53.3,7,21,11,10,17,30,49,0
ITA-Serie A,2425,Venezia,Hans Nicolussi Caviglia,ITA,MF,24-340,2000,30.8,46,28,16,22,8,28,63,44.4,35,38,11,27,27,73,54,2
ITA-Serie A,2425,Venezia,Ionuț Radu,ROU,GK,27-361,1997,14.0,0,0,0,0,0,0,0,,0,0,0,0,0,0,8,0
ITA-Serie A,2425,Venezia,Issa Doumbia,CIV,MF,21-220,2003,9.6,13,8,5,7,1,7,15,46.7,8,16,5,11,7,20,13,1
ITA-Serie A,2425,Venezia,Jay Idzes,IDN,DF,24-356,2000,34.7,45,29,24,17,4,17,33,51.5,16,52,32,20,32,77,156,0
ITA-Serie A,2425,Venezia,Jesse Joronen,FIN,GK,32-064,1993,7.8,0,0,0,0,0,0,0,,0,0,0,0,0,0,4,1
ITA-Serie A,2425,Venezia,Joel Pohjanpalo,FIN,FW,30-253,1994,17.8,3,3,1,2,0,0,4,0.0,4,7,4,3,4,7,24,0
ITA-Serie A,2425,Venezia,John Yeboah,ECU,"FW,MF",24-335,2000,12.6,5,3,1,2,2,1,10,10.0,9,4,0,4,4,9,2,0
ITA-Serie A,2425,Venezia,Joël Schingtienne,BEL,DF,22-285,2002,11.5,21,13,16,4,1,10,16,62.5,6,16,7,9,13,34,24,5
ITA-Serie A,2425,Venezia,Kike Pérez,ESP,MF,28-099,1997,12.1,40,25,18,12,10,18,44,40.9,26,14,2,12,10,50,15,0
ITA-Serie A,2425,Venezia,Magnus Kofod Andersen,DEN,MF,26-014,1999,7.7,13,4,3,9,1,4,10,40.0,6,7,2,5,6,19,12,0
ITA-Serie A,2425,Venezia,Marin Šverko,CRO,DF,27-109,1998,11.6,17,6,11,6,0,8,10,80.0,2,9,4,5,16,33,42,3
ITA-Serie A,2425,Venezia,Michael Svoboda,AUT,DF,26-221,1998,14.6,26,14,19,6,1,8,19,42.1,11,19,11,8,22,48,66,2
ITA-Serie A,2425,Venezia,Mikael Ellertsson,ISL,"DF,MF",23-074,2002,26.5,57,26,36,14,7,32,59,54.2,27,41,5,36,14,71,77,0
ITA-Serie A,2425,Venezia,Mirko Marić,CRO,FW,30-008,1995,3.9,3,2,2,1,0,1,4,25.0,3,3,1,2,1,4,10,0
ITA-Serie A,2425,Venezia,Nicholas Pierini,ITA,MF,26-291,1998,0.9,0,0,0,0,0,0,1,0.0,1,2,0,2,0,0,0,0
ITA-Serie A,2425,Venezia,Nunzio Lella,ITA,MF,24-300,2000,0.1,0,0,0,0,0,0,0,,0,0,0,0,0,0,0,0
ITA-Serie A,2425,Venezia,Richie Sagrado,BEL,DF,21-114,2004,1.6,2,2,1,1,0,1,1,100.0,0,1,0,1,3,5,4,0
ITA-Serie A,2425,Venezia,Ridgeciano Haps,SUR,DF,31-346,1993,14.5,28,15,18,7,3,13,20,65.0,7,17,3,14,7,35,45,0
ITA-Serie A,2425,Venezia,Saad El Haddad,MAR,MF,19-304,2005,0.3,0,0,0,0,0,0,0,,0,0,0,0,0,0,0,0
